richement===richement;
traîtreusement===traîtreusement;
insalubrement===insalubrement;
ouah===ouah;
aigument===aigument;
frauduleusement===frauduleusement;
certainement===certainement;
intoléramment===intoléramment;
amabile===amabile;
rigidement===rigidement;
thermiquement===thermiquement;
impec===impec;
honnêtement===honnêtement;
irrationnellement===irrationnellement;
géotechniquement===géotechniquement;
fabuleusement===fabuleusement;
amoralement===amoralement;
grotesquement===grotesquement;
cellulairement===cellulairement;
intellectuellement===intellectuellement;
résolument===résolument;
assez===assez;
catastrophiquement===catastrophiquement;
optiquement===optiquement;
+===+;
crucialement===crucialement;
évangéliquement===évangéliquement;
ampoulément===ampoulément;
seulement===seulement;
hydrauliquement===hydrauliquement;
électriquement===électriquement;
empiriquement===empiriquement;
anormalement===anormalement;
réversiblement===réversiblement;
démocratiquement===démocratiquement;
intensément===intensément;
implacablement===implacablement;
involontairement===involontairement;
idéalement===idéalement;
zoologiquement===zoologiquement;
passivement===passivement;
professionnellement===professionnellement;
malheureusement===malheureusement;
approbativement===approbativement;
corporellement===corporellement;
tel-quel===tel-quel;
vivement===vivement;
bigrement===bigrement;
titulairement===titulairement;
impitoyablement===impitoyablement;
salement===salement;
largement===largement;
dedans===dedans;
superbement===superbement;
pompeusement===pompeusement;
ostensiblement===ostensiblement;
fièrement===fièrement;
incognito===incognito;
talentueusement===talentueusement;
implicitement===implicitement;
abstraitement===abstraitement;
absurdement===absurdement;
bravement===bravement;
fragilement===fragilement;
distinctivement===distinctivement;
précieusement===précieusement;
intrépidement===intrépidement;
intuitivement===intuitivement;
rhétoriquement===rhétoriquement;
impeccablement===impeccablement;
ordinairement===ordinairement;
élégamment===élégamment;
pareillement===pareillement;
identiquement===identiquement;
irréversiblement===irréversiblement;
disproportionnément===disproportionnément;
patriotiquement===patriotiquement;
rétrospectivement===rétrospectivement;
assai===assai;
débonnairement===débonnairement;
adverbialement===adverbialement;
antécédemment===antécédemment;
nan===nan;
paradoxalement===paradoxalement;
imparfaitement===imparfaitement;
désormais===désormais;
imprécisément===imprécisément;
autrefois===autrefois;
alertement===alertement;
commodément===commodément;
volontiers===volontiers;
horriblement===horriblement;
léthargiquement===léthargiquement;
défensivement===défensivement;
catégoriquement===catégoriquement;
défavorablement===défavorablement;
inopportunément===inopportunément;
excusablement===excusablement;
benoîtement===benoîtement;
prioritairement===prioritairement;
extraordinairement===extraordinairement;
chaotiquement===chaotiquement;
blanchement===blanchement;
studieusement===studieusement;
spéculativement===spéculativement;
immensément===immensément;
photochimiquement===photochimiquement;
anonymement===anonymement;
cagotement===cagotement;
communicativement===communicativement;
habilement===habilement;
deçà===deçà;
justement===justement;
constamment===constamment;
incivilement===incivilement;
biochimiquement===biochimiquement;
seizièmement===seizièmement;
obstinément===obstinément;
dixièmement===dixièmement;
allégretto===allégretto;
icitte===icitte;
sommairement===sommairement;
aigrement===aigrement;
fictivement===fictivement;
approximativement===approximativement;
indécisivement===indécisivement;
jamais===jamais;
notablement===notablement;
majoritairement===majoritairement;
inexactement===inexactement;
heureusement===heureusement;
horizontalement===horizontalement;
apertement===apertement;
éloquemment===éloquemment;
tendrement===tendrement;
glacialement===glacialement;
rationnellement===rationnellement;
soi-disant===soi-disant;
explorativement===explorativement;
déjà===déjà;
structurellement===structurellement;
demain===demain;
déterminément===déterminément;
interminablement===interminablement;
effrontément===effrontément;
opiniâtrement===opiniâtrement;
explicitement===explicitement;
scrupuleusement===scrupuleusement;
partiellement===partiellement;
récemment===récemment;
harmonieusement===harmonieusement;
lascivement===lascivement;
emphatiquement===emphatiquement;
instinctivement===instinctivement;
même===même;
exprès===exprès;
debout===debout;
nominalement===nominalement;
indispensablement===indispensablement;
prochainement===prochainement;
irrévocablement===irrévocablement;
impérativement===impérativement;
grassement===grassement;
cléricalement===cléricalement;
grandement===grandement;
judaïquement===judaïquement;
coquinement===coquinement;
plutôt===plutôt;
défectueusement===défectueusement;
autrement===autrement;
systématiquement===systématiquement;
luxurieusement===luxurieusement;
bassement===bassement;
playback===playback;
obligatoirement===obligatoirement;
quatrièmement===quatrièmement;
supérieurement===supérieurement;
admirativement===admirativement;
véhémentement===véhémentement;
gustativement===gustativement;
affablement===affablement;
super===super;
démographiquement===démographiquement;
obscurément===obscurément;
futilement===futilement;
douteusement===douteusement;
alias===alias;
âprement===âprement;
considérablement===considérablement;
piteusement===piteusement;
fraternellement===fraternellement;
licitement===licitement;
géodésiquement===géodésiquement;
douloureusement===douloureusement;
paisablement===paisablement;
bonnement===bonnement;
obscènement===obscènement;
malhonnêtement===malhonnêtement;
pourquoi===pourquoi;pourquoy;
sérieusement===sérieusement;
artistement===artistement;
capablement===capablement;
ensuite===ensuite;
difficilement===difficilement;
d'ailleurs===d'ailleurs;
complaisamment===complaisamment;
binairement===binairement;
fastidieusement===fastidieusement;
anachroniquement===anachroniquement;
sensiblement===sensiblement;
industriellement===industriellement;
parallèlement===parallèlement;
moins===moins;
cdlt===cdlt;
hier===hier;
ici-bas===ici-bas;
temporairement===temporairement;
colossalement===colossalement;
parentéralement===parentéralement;
immortellement===immortellement;
orgueilleusement===orgueilleusement;
validement===validement;
lamentablement===lamentablement;
royalement===royalement;
visuellement===visuellement;
perso===perso;
suprêmement===suprêmement;
vicieusement===vicieusement;
conceptuellement===conceptuellement;
fâcheusement===fâcheusement;
juvénilement===juvénilement;
budgétairement===budgétairement;
vigilamment===vigilamment;
excentriquement===excentriquement;
sûrement===sûrement;
militairement===militairement;
continuellement===continuellement;
homomorphiquement===homomorphiquement;
hebdomadairement===hebdomadairement;
ministériellement===ministériellement;
historiquement===historiquement;
spécifiquement===spécifiquement;
strictement===strictement;
joliment===joliment;
vite===vite;
droitement===droitement;
dignement===dignement;
stoïquement===stoïquement;
impieusement===impieusement;
alternativement===alternativement;
pieusement===pieusement;
incomplètement===incomplètement;
formellement===formellement;
vertueusement===vertueusement;
illégalement===illégalement;
gaîment===gaîment;
compensatoirement===compensatoirement;
généralement===généralement;
quatorzièmement===quatorzièmement;
botaniquement===botaniquement;
analytiquement===analytiquement;
viscéralement===viscéralement;
adhésivement===adhésivement;
affirmativement===affirmativement;
jadis===jadis;
cash===cash;
contemplativement===contemplativement;
divisiblement===divisiblement;
erronément===erronément;
académiquement===académiquement;
crûment===crûment;
miraculeusement===miraculeusement;
gracieusement===gracieusement;
impassiblement===impassiblement;
niaisement===niaisement;
mathématiquement===mathématiquement;
électromagnétiquement===électromagnétiquement;
secondement===secondement;
lucrativement===lucrativement;
abondamment===abondamment;
fidèlement===fidèlement;
obliquement===obliquement;
sombrement===sombrement;
prudemment===prudemment;
longtemps===longtemps;
gentiment===gentiment;
d'emblée===d'emblée;
comparativement===comparativement;
positivement===positivement;
humainement===humainement;
maxi===maxi;
délibérément===délibérément;
agréablement===agréablement;
imprévument===imprévument;
lâchement===lâchement;
réellement===réellement;
sociologiquement===sociologiquement;
décidément===décidément;
spécialement===spécialement;
tactiquement===tactiquement;
inadmissiblement===inadmissiblement;
comparablement===comparablement;
polyglottement===polyglottement;
statutairement===statutairement;
morphologiquement===morphologiquement;
sectoriellement===sectoriellement;
pacifiquement===pacifiquement;
ambitieusement===ambitieusement;
violemment===violemment;
calamiteusement===calamiteusement;
architecturalement===architecturalement;
honteusement===honteusement;
chirurgicalement===chirurgicalement;
sagement===sagement;
posément===posément;
non===non;
près===près;
tumultueusement===tumultueusement;
asymétriquement===asymétriquement;
rythmiquement===rythmiquement;
tranquillement===tranquillement;
scandaleusement===scandaleusement;
enfin===enfin;
connement===connement;
nûment===nûment;
rituellement===rituellement;
possiblement===possiblement;
soit===soit;
animeusement===animeusement;
bougrement===bougrement;
impénétrablement===impénétrablement;
hideusement===hideusement;
affectivement===affectivement;
affectionnément===affectionnément;
pile===pile;
idéographiquement===idéographiquement;
intégralement===intégralement;
mini===mini;
prou===prou;
quellement===quellement;
câlinement===câlinement;
capricieusement===capricieusement;
commercialement===commercialement;
habituellement===habituellement;
exclusivement===exclusivement;
agitato===agitato;
irrésistiblement===irrésistiblement;
arbitralement===arbitralement;
tout===tout;
foutrement===foutrement;
concrètement===concrètement;
ébullioscopique===ébullioscopique;
élémentairement===élémentairement;
démontrablement===démontrablement;
injustement===injustement;
significativement===significativement;
amphibologiquement===amphibologiquement;
obligeamment===obligeamment;
monotonement===monotonement;
immédiatement===immédiatement;
alogiquement===alogiquement;
journellement===journellement;
métaphoriquement===métaphoriquement;
probablement===probablement;
vrai===vrai;
morganatiquement===morganatiquement;
neuvièmement===neuvièmement;
précocement===précocement;
hermétiquement===hermétiquement;
contractuellement===contractuellement;
littéralement===littéralement;
passionnément===passionnément;
verbalement===verbalement;
acrimonieusement===acrimonieusement;
paternellement===paternellement;
éternellement===éternellement;
hyper===hyper;
provisoirement===provisoirement;
réciproquement===réciproquement;
normalement===normalement;
moralement===moralement;
indissolublement===indissolublement;
figurativement===figurativement;
incompatiblement===incompatiblement;
juvénile===juvénile;
nouvellement===nouvellement;
précisément===précisément;
chimiquement===chimiquement;
indécemment===indécemment;
pécuniairement===pécuniairement;
magnanimement===magnanimement;
improbablement===improbablement;
tristement===tristement;
impuissamment===impuissamment;
coutumièrement===coutumièrement;
hardiment===hardiment;
compulsivement===compulsivement;
couteusement===couteusement;
maigrement===maigrement;
combien===combien;
prétendument===prétendument;
usuellement===usuellement;
continûment===continûment;
contagieusement===contagieusement;
méthodiquement===méthodiquement;
religieusement===religieusement;
tellement===tellement;
anaphoriquement===anaphoriquement;
nécessairement===nécessairement;
crument===crument;
faussement===faussement;
aucunement===aucunement;
candidement===candidement;
conjugalement===conjugalement;
civilement===civilement;
éphémèrement===éphémèrement;
ores===ores;
inconsidérément===inconsidérément;
concentriquement===concentriquement;
fraichement===fraichement;
arbitrairement===arbitrairement;
extérieurement===extérieurement;
irréfutablement===irréfutablement;
canoniquement===canoniquement;
autour===autour;
émotionnellement===émotionnellement;
avant===avant;
long-temps===long-temps;
chastement===chastement;
financièrement===financièrement;
inexcusablement===inexcusablement;
généalogiquement===généalogiquement;
britanniquement===britanniquement;
immuablement===immuablement;
passablement===passablement;
différemment===différemment;
copieusement===copieusement;
jusque===jusque;jusqu;
agressivement===agressivement;
occasionnellement===occasionnellement;
inactivement===inactivement;
aujourd'hui===aujourd'hui;ajourd'hui;aujour-d'hui;
occultement===occultement;
périodiquement===périodiquement;
sic===sic;
tardivement===tardivement;
familièrement===familièrement;
dangereusement===dangereusement;
couramment===couramment;
particulièrement===particulièrement;
théoriquement===théoriquement;
fermement===fermement;
davantage===davantage;
interjectivement===interjectivement;
débilement===débilement;
âcrement===âcrement;
gauchement===gauchement;
primitivement===primitivement;
stérilement===stérilement;
symptomatiquement===symptomatiquement;
tièdement===tièdement;
bizarrement===bizarrement;
facétieusement===facétieusement;
manuellement===manuellement;
craintivement===craintivement;
nasalement===nasalement;
cérémonieusement===cérémonieusement;
fonctionnellement===fonctionnellement;
astucieusement===astucieusement;
génialement===génialement;
ambigument===ambigument;
préalablement===préalablement;
strucurellement===strucurellement;
voluptueusement===voluptueusement;
démonstrativement===démonstrativement;
inexplicablement===inexplicablement;
indignement===indignement;
inélégamment===inélégamment;
perversement===perversement;
vraiement===vraiement;
inlassablement===inlassablement;
décemment===décemment;
irréparablement===irréparablement;
mêmement===mêmement;
libéralement===libéralement;
grave===grave;
intempestivement===intempestivement;
internationalement===internationalement;
brutalement===brutalement;
inégalement===inégalement;
municipalement===municipalement;
sincèrement===sincèrement;
biologiquement===biologiquement;
emmi===emmi;
saintement===saintement;
minablement===minablement;
indissociablement===indissociablement;
émotivement===émotivement;
amèrement===amèrement;
rondement===rondement;
amoureusement===amoureusement;
jovialement===jovialement;
gothiquement===gothiquement;
respectablement===respectablement;
automagiquement===automagiquement;
hypothétiquement===hypothétiquement;
nonchalamment===nonchalamment;
bourgeoisement===bourgeoisement;
décisivement===décisivement;
théologiquement===théologiquement;
incommodément===incommodément;
bactériologiquement===bactériologiquement;
administrativement===administrativement;
frugalement===frugalement;
médiatiquement===médiatiquement;
œnologiquement===œnologiquement;
gigantesquement===gigantesquement;
auparavant===auparavant;
atypiquement===atypiquement;
majestueusement===majestueusement;
ci-dessous===ci-dessous;
précautionneusement===précautionneusement;
cher===cher;
vastement===vastement;
lucidement===lucidement;
neantmoins===neantmoins;
gourmandement===gourmandement;
tacitement===tacitement;
vraiment===vraiment;
allègrement===allègrement;
quotidiennement===quotidiennement;
disciplinairement===disciplinairement;
conséquemment===conséquemment;
bihebdomadairement===bihebdomadairement;
mélancoliquement===mélancoliquement;
étrangement===étrangement;
conjointement===conjointement;
prépositivement===prépositivement;
barbarement===barbarement;
cinquièmement===cinquièmement;
numériquement===numériquement;
plaintivement===plaintivement;
phonétiquement===phonétiquement;
étymologiquement===étymologiquement;
mesquinement===mesquinement;
notoirement===notoirement;
puérilement===puérilement;
failliblement===failliblement;
terriblement===terriblement;
dégoûtamment===dégoûtamment;
diamétralement===diamétralement;
rapidement===rapidement;
sixièmement===sixièmement;
mémorablement===mémorablement;
nuement===nuement;
imminemment===imminemment;
différentiellement===différentiellement;
politiquement===politiquement;
modestement===modestement;
dogmatiquement===dogmatiquement;
cordialement===cordialement;
pluridisciplinairement===pluridisciplinairement;
préférablement===préférablement;
insupportablement===insupportablement;
indéniablement===indéniablement;
disproportionnellement===disproportionnellement;
bureaucratiquement===bureaucratiquement;
rarement===rarement;
andantino===andantino;
imperméablement===imperméablement;
préventivement===préventivement;
prématurément===prématurément;
pêle-mêle===pêle-mêle;
isothermiquement===isothermiquement;
curieusement===curieusement;
anxieusement===anxieusement;
impurement===impurement;
virtuellement===virtuellement;
chouïa===chouïa;chouia;
mutuellement===mutuellement;
fichtre===fichtre;
principalement===principalement;
chèrement===chèrement;
vocalement===vocalement;
autobiographiquement===autobiographiquement;
inofficiellement===inofficiellement;
radieusement===radieusement;
électroniquement===électroniquement;
fiévreusement===fiévreusement;
catalytiquement===catalytiquement;
hypocritement===hypocritement;
moult===moult;
finement===finement;
atrocement===atrocement;
primo===primo;
frivolement===frivolement;
faiblement===faiblement;
thématiquement===thématiquement;
voire===voire;
exceptionnellement===exceptionnellement;
moyennement===moyennement;
magnifiquement===magnifiquement;
magiquement===magiquement;
illisiblement===illisiblement;
entropiquement===entropiquement;
irrésolument===irrésolument;
uniquement===uniquement;
très===très;
artistiquement===artistiquement;
indiscrètement===indiscrètement;
musicalement===musicalement;
ingénieusement===ingénieusement;
intolérablement===intolérablement;
pathétiquement===pathétiquement;
flexiblement===flexiblement;
souverainement===souverainement;
avarement===avarement;
abusivement===abusivement;
irrévéremment===irrévéremment;
antinomiquement===antinomiquement;
chaleureusement===chaleureusement;
confidemment===confidemment;
incestueusement===incestueusement;
rarissimement===rarissimement;
mielleusement===mielleusement;
moqueusement===moqueusement;
idiotement===idiotement;
dehors===dehors;
absolument===absolument;
inexorablement===inexorablement;
gutturalement===gutturalement;
clairement===clairement;
évasivement===évasivement;
cognitivement===cognitivement;
vilainement===vilainement;
avantageusement===avantageusement;
farouchement===farouchement;
doublement===doublement;
d'affilée===d'affilée;
statiquement===statiquement;
àmha===àmha;
artisanalement===artisanalement;
grossièrement===grossièrement;
inaltérablement===inaltérablement;
formidablement===formidablement;
mondialement===mondialement;
consciemment===consciemment;
individuellement===individuellement;
indulgemment===indulgemment;
fertilement===fertilement;
direct===direct;
encore===encore;
stupidement===stupidement;
inutilement===inutilement;
sémantiquement===sémantiquement;
drôlement===drôlement;
ensemble===ensemble;
assurément===assurément;
indûment===indûment;
substantivement===substantivement;
proprement===proprement;
pénalement===pénalement;
aventureusement===aventureusement;
rudement===rudement;
jusqu'alors===jusqu'alors;
improprement===improprement;
également===également;ægalement;
progressivement===progressivement;
sonorement===sonorement;
autoritairement===autoritairement;
asexuellement===asexuellement;
privément===privément;
géographiquement===géographiquement;
indistinctement===indistinctement;
coupablement===coupablement;
marre===marre;
indument===indument;
solidement===solidement;
tousjours===tousjours;
ontologiquement===ontologiquement;
sexuellement===sexuellement;
après-demain===après-demain;
décorativement===décorativement;
nerveusement===nerveusement;
durablement===durablement;
publiquement===publiquement;
précipitamment===précipitamment;
pratiquement===pratiquement;
doucement===doucement;
négligemment===négligemment;
extensivement===extensivement;
acrobatiquement===acrobatiquement;
chattement===chattement;
bénignement===bénignement;
somptueusement===somptueusement;
sus===sus;
docilement===docilement;
évidemment===évidemment;
athlétiquement===athlétiquement;
chevaleresquement===chevaleresquement;
singulièrement===singulièrement;
savamment===savamment;
souvent===souvent;
explosivement===explosivement;
oui===oui;voui;
vis-à-vis===vis-à-vis;
placidement===placidement;
victorieusement===victorieusement;
impulsivement===impulsivement;
flegmatiquement===flegmatiquement;
substantiellement===substantiellement;
sexyment===sexyment;
valablement===valablement;
allégro===allégro;
lestement===lestement;
conventionnellement===conventionnellement;
droit===droit;
comptant===comptant;
personnellement===personnellement;
latéralement===latéralement;
laidement===laidement;
juridiquement===juridiquement;
douzièmement===douzièmement;
triplement===triplement;
qualitativement===qualitativement;
sourdement===sourdement;
derechef===derechef;
pourtant===pourtant;
astheure===astheure;
directos===directos;
pudiquement===pudiquement;
bruyamment===bruyamment;
diablement===diablement;
abominablement===abominablement;
précédemment===précédemment;
congénitalement===congénitalement;
inéluctablement===inéluctablement;
fortuitement===fortuitement;
charnellement===charnellement;
certes===certes;
funestement===funestement;
itérativement===itérativement;
consécutivement===consécutivement;
irrévocable===irrévocable;
balistiquement===balistiquement;
virilement===virilement;
n'empêche===n'empêche;
opérationnellement===opérationnellement;
pleinement===pleinement;
bientôt===bientôt;
urgemment===urgemment;
quasi===quasi;
fadement===fadement;
irréductiblement===irréductiblement;
fougueusement===fougueusement;
diligemment===diligemment;
visiblement===visiblement;
quand===quand;
ainsi===ainsi;
répétitivement===répétitivement;
indescriptiblement===indescriptiblement;
arrogamment===arrogamment;
officieusement===officieusement;
succulemment===succulemment;
simultanément===simultanément;
vraisemblablement===vraisemblablement;
expéditivement===expéditivement;
sainement===sainement;
fréquemment===fréquemment;
allopathiquement===allopathiquement;
librement===librement;
mûrement===mûrement;
subrepticement===subrepticement;
instantanément===instantanément;
frénétiquement===frénétiquement;
naturellement===naturellement;
impétueusement===impétueusement;
déshonnêtement===déshonnêtement;
préférentiellement===préférentiellement;
délicieusement===délicieusement;
mentalement===mentalement;
élogieusement===élogieusement;
mélodiquement===mélodiquement;
vachement===vachement;
culturellement===culturellement;
potentiellement===potentiellement;
départementalement===départementalement;
carrément===carrément;
onc===onc;
altièrement===altièrement;
matériellement===matériellement;
n'importe===n'importe;
inintelligemment===inintelligemment;
cependant===cependant;
robustement===robustement;
chichement===chichement;
illico===illico;
continument===continument;
conformément===conformément;
flagramment===flagramment;
dramatiquement===dramatiquement;
gaillardement===gaillardement;
quant===quant;
économiquement===économiquement;œconomiquement;
sarcastiquement===sarcastiquement;
inoffensivement===inoffensivement;
premier===premier;
cinétiquement===cinétiquement;
sympathiquement===sympathiquement;
phlegmatiquement===phlegmatiquement;
hors===hors;
secrètement===secrètement;
oppressivement===oppressivement;
mensuellement===mensuellement;
radialement===radialement;
fixement===fixement;
intimement===intimement;
indestructiblement===indestructiblement;
diaboliquement===diaboliquement;
incisivement===incisivement;
ex-aequo===ex-aequo;
idiographiquement===idiographiquement;
gravement===gravement;
concurremment===concurremment;
méchamment===méchamment;
lugubrement===lugubrement;
transitivement===transitivement;
axiomatiquement===axiomatiquement;
fémininement===fémininement;
figurément===figurément;
encor===encor;
malicieusement===malicieusement;
dépendamment===dépendamment;
froidement===froidement;
momentanément===momentanément;
indubitablement===indubitablement;
radicalement===radicalement;
bis===bis;
canonialement===canonialement;
complètement===complètement;complétement;
sacrilégement===sacrilégement;
universellement===universellement;
minéralogiquement===minéralogiquement;
socialement===socialement;
impérieusement===impérieusement;
définitivement===définitivement;
grièvement===grièvement;
processionnellement===processionnellement;
orageusement===orageusement;
classiquement===classiquement;
langoureusement===langoureusement;
vénalement===vénalement;
énormément===énormément;
nationalement===nationalement;
toujours===toujours;
poétiquement===poétiquement;
rustiquement===rustiquement;
inintelligiblement===inintelligiblement;
subversivement===subversivement;
suffisamment===suffisamment;
timidement===timidement;
infréquemment===infréquemment;
modernement===modernement;
faux===faux;
comiquement===comiquement;
énigmatiquement===énigmatiquement;ænigmatiquement;
goutte===goutte;
modérément===modérément;
crédulement===crédulement;
inhabilement===inhabilement;
sitôt===sitôt;
tant===tant;
techniquement===techniquement;
obéissamment===obéissamment;
mystiquement===mystiquement;
sentimentalement===sentimentalement;
magistralement===magistralement;
inoubliablement===inoubliablement;
affreusement===affreusement;
ridiculement===ridiculement;
subitement===subitement;
stériquement===stériquement;
sélectivement===sélectivement;
autocratiquement===autocratiquement;
ponctuellement===ponctuellement;
pittoresquement===pittoresquement;
interactivement===interactivement;
petitement===petitement;
éthiquement===éthiquement;
goulument===goulument;goulûment;
glorieusement===glorieusement;
épais===épais;
sciemment===sciemment;
abstractivement===abstractivement;
assidûment===assidûment;
activement===activement;
rapide===rapide;
actuellement===actuellement;
allusivement===allusivement;
rétroactivement===rétroactivement;
bilatéralement===bilatéralement;
quelquefois===quelquefois;
mignonnement===mignonnement;
fatidiquement===fatidiquement;
courageusement===courageusement;
pas===pas;
étourdiment===étourdiment;
expertement===expertement;
dynamiquement===dynamiquement;
céans===céans;
exponentiellement===exponentiellement;
objectivement===objectivement;
rapido===rapido;
rêveusement===rêveusement;
bêtement===bêtement;
excessivement===excessivement;
attentivement===attentivement;
fugitivement===fugitivement;
hautement===hautement;
ethniquement===ethniquement;
ecclésiastiquement===ecclésiastiquement;
angulairement===angulairement;
animalement===animalement;
foncièrement===foncièrement;
calmement===calmement;
hygiéniquement===hygiéniquement;
flatteusement===flatteusement;
prestement===prestement;
avant-hier===avant-hier;
parfaitement===parfaitement;
chiquement===chiquement;
fichtrement===fichtrement;
accidentellement===accidentellement;
infiniment===infiniment;
génétiquement===génétiquement;
géologiquement===géologiquement;
intentionnellement===intentionnellement;
malproprement===malproprement;
mythologiquement===mythologiquement;
doctement===doctement;
drastiquement===drastiquement;
couci-couça===couci-couça;
noblement===noblement;
verticalement===verticalement;
tard===tard;
accortement===accortement;
symboliquement===symboliquement;
annuellement===annuellement;
sournoisement===sournoisement;
bas===bas;
partout===partout;
expressément===expressément;
maritalement===maritalement;
inflexiblement===inflexiblement;
mystérieusement===mystérieusement;
vaguement===vaguement;
peu===peu;
insuffisamment===insuffisamment;
doctrinalement===doctrinalement;
journalistiquement===journalistiquement;
rugueusement===rugueusement;
ardemment===ardemment;
paisiblement===paisiblement;
peut-être===peut-être;
polyphoniquement===polyphoniquement;
linguistiquement===linguistiquement;
impartialement===impartialement;
discutablement===discutablement;
aimablement===aimablement;
casuellement===casuellement;
dix-huitièmement===dix-huitièmement;
sacrément===sacrément;
éventuellement===éventuellement;
virulemment===virulemment;
invisiblement===invisiblement;
lexicographiquement===lexicographiquement;
physiquement===physiquement;
moultes===moultes;
vaillamment===vaillamment;
irréellement===irréellement;
coûteusement===coûteusement;
épisodiquement===épisodiquement;
péniblement===péniblement;
supposément===supposément;
correctement===correctement;
couci-couci===couci-couci;
relativement===relativement;
irrépréhensiblement===irrépréhensiblement;
prodigieusement===prodigieusement;
typiquement===typiquement;
audacieusement===audacieusement;
hiérarchiquement===hiérarchiquement;
succinctement===succinctement;
cumulativement===cumulativement;
enfantinement===enfantinement;
irresponsablement===irresponsablement;
traditionnellement===traditionnellement;
soigneusement===soigneusement;
antérieurement===antérieurement;
pensivement===pensivement;
rageusement===rageusement;
haineusement===haineusement;
déloyalement===déloyalement;
lexicalement===lexicalement;
plaisamment===plaisamment;
incorruptiblement===incorruptiblement;
diplomatiquement===diplomatiquement;
quoi===quoi;
incomparablement===incomparablement;
psychologiquement===psychologiquement;
distraitement===distraitement;
successivement===successivement;
gratos===gratos;
pis===pis;
angéliquement===angéliquement;
avidement===avidement;
honorablement===honorablement;
adversativement===adversativement;
adagio===adagio;
densément===densément;
huitièmement===huitièmement;
indisputablement===indisputablement;
toutefois===toutefois;
moléculairement===moléculairement;
cohéremment===cohéremment;
créativement===créativement;
trivialement===trivialement;
affetto===affetto;
infailliblement===infailliblement;
méticuleusement===méticuleusement;
illicitement===illicitement;
expérimentalement===expérimentalement;
itou===itou;
d'où===d'où;
malencontreusement===malencontreusement;
incontestablement===incontestablement;
cursivement===cursivement;
éminemment===éminemment;
initialement===initialement;
nonobstant===nonobstant;
spontanément===spontanément;
hâtivement===hâtivement;
contrairement===contrairement;
arioso===arioso;
auprès===auprès;
perpétuellement===perpétuellement;
œcologiquement===œcologiquement;
cycliquement===cycliquement;
bonbon===bonbon;
conditionnellement===conditionnellement;
insolemment===insolemment;
dûment===dûment;
totalement===totalement;
imperturbablement===imperturbablement;
astronomiquement===astronomiquement;
lapidairement===lapidairement;
merveilleusement===merveilleusement;
burlesquement===burlesquement;
jalousement===jalousement;
incompétemment===incompétemment;
radiochronologiquement===radiochronologiquement;
surtout===surtout;
banalement===banalement;
fervemment===fervemment;
laconiquement===laconiquement;
enharmoniquement===enharmoniquement;
synergiquement===synergiquement;
après===après;
inefficacement===inefficacement;
diagonalement===diagonalement;
hargneusement===hargneusement;
péremptoirement===péremptoirement;
infidèlement===infidèlement;
effectivement===effectivement;
indivisiblement===indivisiblement;
dix-neuvièmement===dix-neuvièmement;
aristocratiquement===aristocratiquement;
contradictoirement===contradictoirement;
graphiquement===graphiquement;
coopérativement===coopérativement;
dessous===dessous;
vulgairement===vulgairement;
entretemps===entretemps;entre-temps;
nonantièmement===nonantièmement;
adonc===adonc;
ultérieurement===ultérieurement;
inamicalement===inamicalement;
indélicatement===indélicatement;
là-bas===là-bas;
innocemment===innocemment;
prosaïquement===prosaïquement;
offensivement===offensivement;
uniformément===uniformément;
textuellement===textuellement;
frileusement===frileusement;
scolairement===scolairement;
invinciblement===invinciblement;
jusqu'ici===jusqu'ici;
collectivement===collectivement;
confidentiellement===confidentiellement;
dare-dare===dare-dare;
d'ordinaire===d'ordinaire;
parfois===parfois;
dévotement===dévotement;
légitimement===légitimement;
réglementairement===réglementairement;
spectralement===spectralement;
vertement===vertement;
impunément===impunément;
incidemment===incidemment;
désavantageusement===désavantageusement;
contestablement===contestablement;
minutieusement===minutieusement;
désespérément===désespérément;
tragiquement===tragiquement;
conditionnement===conditionnement;
affettuoso===affettuoso;
bellement===bellement;
mollement===mollement;
accessoirement===accessoirement;
concisément===concisément;
vieillement===vieillement;
informellement===informellement;
constitutionnellement===constitutionnellement;
déplorablement===déplorablement;
automatiquement===automatiquement;
synthétiquement===synthétiquement;
divinement===divinement;
couardement===couardement;
sobrement===sobrement;
physiologiquement===physiologiquement;
austèrement===austèrement;
fraîchement===fraîchement;
cabalistiquement===cabalistiquement;
brièvement===brièvement;
anecdotiquement===anecdotiquement;
légèrement===légèrement;
exactement===exactement;
antiquement===antiquement;
semestriellement===semestriellement;
funèbrement===funèbrement;
convertiblement===convertiblement;
guère===guère;
fallacieusement===fallacieusement;
luxueusement===luxueusement;
oralement===oralement;
spirituellement===spirituellement;
inconfortablement===inconfortablement;
naïvement===naïvement;
oisivement===oisivement;
dernièrement===dernièrement;
anticonstitutionnellement===anticonstitutionnellement;
inclusivement===inclusivement;
vigoureusement===vigoureusement;
chronologiquement===chronologiquement;
cyniquement===cyniquement;
joyeusement===joyeusement;
perpendiculairement===perpendiculairement;
aussitôt===aussitôt;
volontairement===volontairement;
énergiquement===énergiquement;
follement===follement;
intérieurement===intérieurement;
orthographiquement===orthographiquement;
incalculablement===incalculablement;
galamment===galamment;
quasiment===quasiment;
sèchement===sèchement;
irrémissiblement===irrémissiblement;
étonnamment===étonnamment;
septièmement===septièmement;
intransitivement===intransitivement;
abruptement===abruptement;
énergétiquement===énergétiquement;
érotiquement===érotiquement;
lourdement===lourdement;
nommément===nommément;
bibliquement===bibliquement;
cosmologiquement===cosmologiquement;
masculinement===masculinement;
inséparablement===inséparablement;
nettement===nettement;
imbécilement===imbécilement;
allegro===allegro;
épatamment===épatamment;
virginalement===virginalement;
désastreusement===désastreusement;
pauvrement===pauvrement;
aveuglément===aveuglément;
invariablement===invariablement;
immodérément===immodérément;
distinctement===distinctement;
effroyablement===effroyablement;
furtivement===furtivement;
syntaxiquement===syntaxiquement;
originellement===originellement;
trop===trop;
indomptablement===indomptablement;
fondamentalement===fondamentalement;
censément===censément;
logiquement===logiquement;
impersonnellement===impersonnellement;
gyroscopiquement===gyroscopiquement;
pertinemment===pertinemment;
postérieurement===postérieurement;
poliment===poliment;
irréprochablement===irréprochablement;
généreusement===généreusement;
perfidement===perfidement;
crissement===crissement;
sporadiquement===sporadiquement;
amha===amha;
sinistrement===sinistrement;
surabondamment===surabondamment;
épouvantablement===épouvantablement;
imperceptiblement===imperceptiblement;
maintefois===maintefois;
environnementalement===environnementalement;
autant===autant;
purement===purement;
mal===mal;
efficacement===efficacement;
intensivement===intensivement;
régulièrement===régulièrement;
inconditionnellement===inconditionnellement;
consciencieusement===consciencieusement;
aussitost===aussitost;
tantôt===tantôt;
agilement===agilement;
insulairement===insulairement;
inhabituellement===inhabituellement;
didactiquement===didactiquement;
macache===macache;
gaiment===gaiment;
affectueusement===affectueusement;
honorifiquement===honorifiquement;
fructueusement===fructueusement;
indirectement===indirectement;
expressivement===expressivement;
euphoniquement===euphoniquement;
romantiquement===romantiquement;
bénéficiairement===bénéficiairement;
hypnotiquement===hypnotiquement;
amplement===amplement;
vîte===vîte;
là-haut===là-haut;
peureusement===peureusement;
phénoménalement===phénoménalement;
adéquatement===adéquatement;
forcément===forcément;
illégitimement===illégitimement;
soupçonneusement===soupçonneusement;
fastueusement===fastueusement;
exquisément===exquisément;
inconsciemment===inconsciemment;
technologiquement===technologiquement;
ci===ci;
anarchiquement===anarchiquement;
férocement===férocement;
mélodieusement===mélodieusement;
aisément===aisément;
onzièmement===onzièmement;
opportunément===opportunément;
apostoliquement===apostoliquement;
tantinet===tantinet;
ici===ici;
conjecturalement===conjecturalement;
globalement===globalement;
présentement===présentement;præsentement;
dix-septièmement===dix-septièmement;
puissamment===puissamment;
colériquement===colériquement;
bénévolement===bénévolement;
inextricablement===inextricablement;
fanatiquement===fanatiquement;
cinématographiquement===cinématographiquement;
génériquement===génériquement;
ingénument===ingénument;
algébriquement===algébriquement;
ouaille===ouaille;
amiablement===amiablement;
misérablement===misérablement;
véritablement===véritablement;
franchement===franchement;
triomphalement===triomphalement;
loyalement===loyalement;
éperdument===éperdument;
intrinsèquement===intrinsèquement;
aléatoirement===aléatoirement;
treizièmement===treizièmement;
onques===onques;
muablement===muablement;
puis===puis;
littérairement===littérairement;
insidieusement===insidieusement;
clandestinement===clandestinement;
admirablement===admirablement;
irrépressiblement===irrépressiblement;
sauvagement===sauvagement;
donc===donc;
ineffaçablement===ineffaçablement;
or===or;
alphabétiquement===alphabétiquement;
çà===çà;
maladroitement===maladroitement;
là===là;
amphigouriquement===amphigouriquement;
complémentairement===complémentairement;
exécrablement===exécrablement;
statistiquement===statistiquement;
amoroso===amoroso;
comment===comment;
authentiquement===authentiquement;
anthropologiquement===anthropologiquement;
d'abord===d'abord;
juste===juste;
ex-æquo===ex-æquo;
presque===presque;
facilement===facilement;
ahurissamment===ahurissamment;
mécaniquement===mécaniquement;
d'main===d'main;
constructivement===constructivement;
adjectivement===adjectivement;
schématiquement===schématiquement;
stylistiquement===stylistiquement;
impoliment===impoliment;
médiocrement===médiocrement;
géométriquement===géométriquement;
indifféremment===indifféremment;
sentencieusement===sentencieusement;
écologiquement===écologiquement;
notamment===notamment;
profusément===profusément;
soudainement===soudainement;
allégoriquement===allégoriquement;
transversalement===transversalement;
clopin-clopant===clopin-clopant;
croyablement===croyablement;
tangiblement===tangiblement;
illogiquement===illogiquement;
cristallographiquement===cristallographiquement;
chaud===chaud;
équitablement===équitablement;
irréfragablement===irréfragablement;
judicieusement===judicieusement;
dur===dur;
amicalement===amicalement;
jà===jà;
item===item;
médicalement===médicalement;
excellemment===excellemment;
lisiblement===lisiblement;
sereinement===sereinement;
diminutivement===diminutivement;
anciennement===anciennement;
beaucoup===beaucoup;
lentement===lentement;
abandonnément===abandonnément;
indépendamment===indépendamment;
criminellement===criminellement;
longuement===longuement;
outre-Manche===outre-Manche;
troisièmement===troisièmement;
stratégiquement===stratégiquement;
subtilement===subtilement;
unanimement===unanimement;
impatiemment===impatiemment;
héroïquement===héroïquement;
ci-dessus===ci-dessus;
entièrement===entièrement;
environ===environ;
idem===idem;
quinzièmement===quinzièmement;
vitement===vitement;
fatalement===fatalement;
envieusement===envieusement;
silencieusement===silencieusement;
dorénavant===dorénavant;
séparément===séparément;
impossiblement===impossiblement;
indiscutablement===indiscutablement;
charitablement===charitablement;
fiscalement===fiscalement;
solidairement===solidairement;
confortablement===confortablement;
courtoisement===courtoisement;
lors===lors;
mortellement===mortellement;
remarquablement===remarquablement;
fébrilement===fébrilement;
philosophiquement===philosophiquement;
gratuitement===gratuitement;
thermodynamiquement===thermodynamiquement;
humblement===humblement;
fortement===fortement;
officiellement===officiellement;
ultimement===ultimement;
andante===andante;
inexprimablement===inexprimablement;
adorablement===adorablement;
rigoureusement===rigoureusement;
gaiement===gaiement;
superficiellement===superficiellement;
discrètement===discrètement;
infructueusement===infructueusement;
négativement===négativement;
directement===directement;
analogiquement===analogiquement;
assidument===assidument;
symétriquement===symétriquement;
imprudemment===imprudemment;
uniment===uniment;
graduellement===graduellement;
linéairement===linéairement;
etc.===etc.;
intelligemment===intelligemment;
régionalement===régionalement;
sportivement===sportivement;
aussi===aussi;
bestialement===bestialement;
solennellement===solennellement;
confusément===confusément;
durement===durement;
exotiquement===exotiquement;
vainement===vainement;
favorablement===favorablement;
chrétiennement===chrétiennement;
fautivement===fautivement;
incontinent===incontinent;
ironiquement===ironiquement;
quantitativement===quantitativement;
incessamment===incessamment;
convenablement===convenablement;
passagèrement===passagèrement;
malaisément===malaisément;
humidement===humidement;
vu===vu;
furieusement===furieusement;
finalement===finalement;
catholiquement===catholiquement;
dédaigneusement===dédaigneusement;
allégrement===allégrement;
instamment===instamment;
ouvertement===ouvertement;
sur-le-champ===sur-le-champ;
massivement===massivement;
profondément===profondément;
nutritionnellement===nutritionnellement;
fortissimo===fortissimo;
brioso===brioso;
fugacement===fugacement;
instablement===instablement;
dextrement===dextrement;
ennuyeusement===ennuyeusement;
subséquemment===subséquemment;
infatigablement===infatigablement;
variablement===variablement;
incorrigiblement===incorrigiblement;
irrévérencieusement===irrévérencieusement;
cavalièrement===cavalièrement;
hui===hui;
interchangeablement===interchangeablement;
étroitement===étroitement;
abrégément===abrégément;
isométriquement===isométriquement;
justifiablement===justifiablement;
impensablement===impensablement;
cahin-caha===cahin-caha;
machinalement===machinalement;
où===où;
maintenant===maintenant;
inversement===inversement;
utilement===utilement;
indéchiffrablement===indéchiffrablement;
cliniquement===cliniquement;
inéquitablement===inéquitablement;
si===si;
délicatement===délicatement;
dégueulassement===dégueulassement;
monstrueusement===monstrueusement;
enthousiastement===enthousiastement;
adroitement===adroitement;
inimitablement===inimitablement;
d'accord===d'accord;
respectivement===respectivement;
lento===lento;
odieusement===odieusement;
dument===dument;
inévitablement===inévitablement;
subjectivement===subjectivement;
analement===analement;
marginalement===marginalement;
transitoirement===transitoirement;
brusquement===brusquement;
essentiellement===essentiellement;
delà===delà;
incorrectement===incorrectement;
calmos===calmos;
dru===dru;
raisonnablement===raisonnablement;
pantoute===pantoute;
promptement===promptement;
irrégulièrement===irrégulièrement;
partialement===partialement;
paresseusement===paresseusement;
bref===bref;
dessus===dessus;
gravitationnellement===gravitationnellement;
incroyablement===incroyablement;
nativement===nativement;
ailleurs===ailleurs;
immoralement===immoralement;
respectueusement===respectueusement;
naguère===naguère;
communément===communément;
localement===localement;
harmoniquement===harmoniquement;
démesurément===démesurément;
idéologiquement===idéologiquement;
diversement===diversement;
d'arrache-pied===d'arrache-pied;
inopinément===inopinément;
plus===plus;
immanquablement===immanquablement;
manifestement===manifestement;
loin===loin;
territorialement===territorialement;
ensuit===ensuit;
irrémédiablement===irrémédiablement;
arithmétiquement===arithmétiquement;
fort===fort;
fameusement===fameusement;
légalement===légalement;
cybernétiquement===cybernétiquement;
inconsolablement===inconsolablement;
alcooliquement===alcooliquement;
incurablement===incurablement;
impudemment===impudemment;
pesamment===pesamment;
suavement===suavement;
déraisonnablement===déraisonnablement;
intelligiblement===intelligiblement;
désagréablement===désagréablement;
dubitativement===dubitativement;
nullement===nullement;
simplement===simplement;
voracement===voracement;
alentour===alentour;
patiemment===patiemment;
déontologiquement===déontologiquement;
extrêmement===extrêmement;
détestablement===détestablement;
irrespectueusement===irrespectueusement;
augustement===augustement;
grammaticalement===grammaticalement;
trompeusement===trompeusement;
brillamment===brillamment;
plébéiennement===plébéiennement;
esthétiquement===esthétiquement;æsthétiquement;
point===point;
coquettement===coquettement;
nuitamment===nuitamment;
philologiquement===philologiquement;
mie===mie;
insensiblement===insensiblement;
amen===amen;
oncques===oncques;
obsessionnellement===obsessionnellement;
sensuellement===sensuellement;
tempétueusement===tempétueusement;
isolément===isolément;
égoïstement===égoïstement;
bien===bien;
biographiquement===biographiquement;
circulairement===circulairement;
artificiellement===artificiellement;
sottement===sottement;
métaphysiquement===métaphysiquement;
deuxièmement===deuxièmement;
derrière===derrière;
impertinemment===impertinemment;
anatomiquement===anatomiquement;
premièrement===premièrement;
abréviativement===abréviativement;
cosmiquement===cosmiquement;
corrélativement===corrélativement;
flamboyamment===flamboyamment;
içi===içi;
obséquieusement===obséquieusement;
cruellement===cruellement;
bouffonnement===bouffonnement;
chaudement===chaudement;
magnétiquement===magnétiquement;
sévèrement===sévèrement;
héréditairement===héréditairement;
maternellement===maternellement;
fantastiquement===fantastiquement;
proportionnellement===proportionnellement;
apparemment===apparemment;
vaginalement===vaginalement;
calomnieusement===calomnieusement;
vingtièmement===vingtièmement;
unilatéralement===unilatéralement;
tôt===tôt;
souterrainement===souterrainement;
rétronasalement===rétronasalement;
dictatorialement===dictatorialement;
outrageusement===outrageusement;
spectaculairement===spectaculairement;
moindrement===moindrement;
spatialement===spatialement;
haut===haut;
d'habitude===d'habitude;
nominativement===nominativement;
exagérément===exagérément;
scientifiquement===scientifiquement;
