vurig===vurig;
grijzig===grijzig;grijzige;grijziger;grijzigs;grijzigst;
Tsjetsjeens===Tsjetsjeens;
religieus===religieus;religieust;religieuze;religieuzer;
ondiep===ondiep;ondiepe;
zoor===zoor;
ineffectief===ineffectief;ineffectiefst;ineffectiever;
geschoeid===geschoeid;
onpersoonlijk===onpersoonlijk;
verkwistend===verkwistend;
rechtlijnig===rechtlijnig;rechtlijniger;rechtlijnigst;
strijdbaar===strijdbaar;
heel===heel;
hees===hees;heest;
gedeputeerd===gedeputeerd;
benedictijner===benedictijner;
spoedig===spoedig;spoediger;spoedigst;
sloom===sloom;
heet===heet;
eervol===eervol;
intiem===intiem;intiemer;intiemst;
noordwaarts===noordwaarts;
offensief===offensief;offensiefst;offensieve;offensiever;
verrekt===verrekt;
plooibaar===plooibaar;plooibaarder;plooibaarst;plooibare;
loefwaarts===loefwaarts;
veertigste===veertigste;
Amstels===Amstels;
lichtgewicht===lichtgewicht;
ambteloos===ambteloos;
geldig===geldig;
voortdurend===voortdurend;
dusdanig===dusdanig;dusdanige;
spookachtig===spookachtig;
gestreept===gestreept;
Armeens===Armeens;Armeenser;Armeenst;
bezeten===bezeten;
mineraal===mineraal;
strategisch===strategisch;strategische;
rondborstig===rondborstig;
satirisch===satirisch;satirische;satirischer;satirischt;
gemeentelijk===gemeentelijk;gemeentelijke;
vergezocht===vergezocht;
groot===groot;groots;grootst;
vijfvoudig===vijfvoudig;vijfvoudige;
kapot===kapot;
onmiddellijk===onmiddellijk;
wekelijks===wekelijks;
zeer===zeer;zeers;
echt===echt;echte;echts;
schraal===schraal;
afschuwelijk===afschuwelijk;afschuwelijke;
tweede===tweede;
geilig===geilig;
optisch===optisch;optische;
bedrieglijk===bedrieglijk;
ongevaarlijk===ongevaarlijk;ongevaarlijke;
maandelijks===maandelijks;maandelijkse;
lichtgroen===lichtgroen;
ongedwongen===ongedwongen;
vanzelfsprekend===vanzelfsprekend;vanzelfsprekender;vanzelfsprekendst;
akoestisch===akoestisch;akoestische;
gloednieuw===gloednieuw;
verwarrend===verwarrend;verwarrende;
moedig===moedig;moedige;
gewelddadig===gewelddadig;gewelddadiger;gewelddadigst;
kruidig===kruidig;
vaag===vaag;
vaal===vaal;
zuurstofrijk===zuurstofrijk;zuurstofrijke;
hartstochtelijk===hartstochtelijk;
vaak===vaak;
archeologisch===archeologisch;archeologische;
nominaal===nominaal;
tactvol===tactvol;tactvoller;tactvolst;
kardinaal===kardinaal;
hoofdlettergevoelig===hoofdlettergevoelig;
middeleeuws===middeleeuws;middeleeuwse;
verlegen===verlegen;
allochtoon===allochtoon;
rap===rap;
geaaid===geaaid;geaaide;
plotseling===plotseling;plotselinge;plotselings;
draadloos===draadloos;
transparant===transparant;transparante;
fortuinlijk===fortuinlijk;fortuinlijker;fortuinlijkst;
achterwaarts===achterwaarts;achterwaartse;
immens===immens;immense;
Duits===Duits;Duitse;Duitst;
Pruisisch===Pruisisch;
tegendraads===tegendraads;
bolvormig===bolvormig;
Amsterdams===Amsterdams;
identiek===identiek;identieke;identieker;identiekst;
moeiteloos===moeiteloos;
verantwoordelijk===verantwoordelijk;verantwoordelijker;verantwoordelijkst;
matriarchaal===matriarchaal;
jong===jong;jonge;
rasecht===rasecht;rasechte;rasechter;rasechts;rasechtst;
vernederend===vernederend;
Romeins===Romeins;
rad===rad;
behapbaar===behapbaar;
volslank===volslank;
heilig===heilig;heilige;heiliger;heiligst;
grandioos===grandioos;grandioost;grandioze;grandiozer;
thermaal===thermaal;thermale;
verveeld===verveeld;
onderdrukt===onderdrukt;onderdrukte;
doorlatend===doorlatend;doorlatende;doorlatender;doorlatends;doorlatendst;
stokstijf===stokstijf;
scheidbaar===scheidbaar;
aansprakelijk===aansprakelijk;
hels===hels;
engelachtig===engelachtig;
ontzettend===ontzettend;
kosteloos===kosteloos;kosteloze;
semantisch===semantisch;semantische;
indigo===indigo;
zalig===zalig;
ros===ros;rost;
maoïstisch===maoïstisch;
rot===rot;
verslaafd===verslaafd;
groen===groen;groene;groener;groens;groenst;
eigen===eigen;
voortvluchtig===voortvluchtig;
luidruchtig===luidruchtig;luidruchtiger;luidruchtigst;
verkouden===verkouden;
dominant===dominant;dominante;
vijfde===vijfde;
onbehoorlijk===onbehoorlijk;
onbepaald===onbepaald;
Panamees===Panamees;
rof===rof;
veelzijdig===veelzijdig;
industrieel===industrieel;industriële;
etherisch===etherisch;
westers===westers;
bezig===bezig;
gewiekst===gewiekst;
onbegeleid===onbegeleid;
sinusoïdaal===sinusoïdaal;
murw===murw;murwe;murws;
gemengd===gemengd;gemengde;
tropisch===tropisch;tropische;
voorhistorisch===voorhistorisch;voorhistorische;
zoek===zoek;
Polynesisch===Polynesisch;Polynesische;
ontzaglijk===ontzaglijk;
piepjong===piepjong;
zoet===zoet;
groepsgewijs===groepsgewijs;
zacht===zacht;zachte;zachter;zachtst;
mondig===mondig;
mateloos===mateloos;
voltallig===voltallig;
dienstig===dienstig;
ezelachtig===ezelachtig;
zalmkleurig===zalmkleurig;
finaal===finaal;
uitsluitend===uitsluitend;
isogeen===isogeen;
nederig===nederig;
glazen===glazen;
magnetisch===magnetisch;magnetische;
literair===literair;literaire;
dragelijk===dragelijk;
naoorlogs===naoorlogs;
prat===prat;
onthutst===onthutst;
fysiek===fysiek;fysieke;
broos===broos;broost;
metrisch===metrisch;metrische;
ongehoorzaam===ongehoorzaam;
afkomstig===afkomstig;
bovenwinds===bovenwinds;
nutteloos===nutteloos;nutteloost;nutteloze;nuttelozer;
gemeen===gemeen;gemeenst;gemener;
overleden===overleden;
principieel===principieel;
weinig===weinig;weinige;
onverdienstelijk===onverdienstelijk;
cyaan===cyaan;
geurig===geurig;geurige;geuriger;geurigst;
smakeloos===smakeloos;smakeloost;smakelozer;
deftig===deftig;deftiger;deftigst;
eerder===eerder;
ritmisch===ritmisch;ritmische;ritmischer;ritmischt;
tranerig===tranerig;
onrein===onrein;
druk===druk;
vals===vals;valse;
dito===dito;
waard===waard;waarde;
stuitend===stuitend;stuitende;
tweetalig===tweetalig;tweetalige;
sleets===sleets;sleetser;
Chinees===Chinees;
tussentijds===tussentijds;
gebiedend===gebiedend;
gepast===gepast;
zorgwekkend===zorgwekkend;zorgwekkender;
kinderachtig===kinderachtig;kinderachtiger;kinderachtigst;
onenig===onenig;onenige;oneniger;onenigs;onenigst;
assertief===assertief;
mobiel===mobiel;
vruchtbaar===vruchtbaar;vruchtbaarder;vruchtbaars;vruchtbaarst;vruchtbare;
donker===donker;donkere;donkerst;
mechanisch===mechanisch;
opwaarts===opwaarts;
piep===piep;
gewaar===gewaar;
buigzaam===buigzaam;buigzaams;buigzaamst;buigzame;
bebaard===bebaard;
geleerd===geleerd;geleerde;
gepaard===gepaard;
dierbaar===dierbaar;dierbaarder;dierbaarst;
afstandelijk===afstandelijk;afstandelijke;afstandelijker;afstandelijkst;
albino===albino;
bijtijds===bijtijds;
naakt===naakt;naakte;
plantaardig===plantaardig;
schaars===schaars;schaarser;schaarst;
aanschouwelijk===aanschouwelijk;aanschouwelijke;aanschouwelijker;aanschouwelijks;aanschouwelijkst;
gelijkwaardig===gelijkwaardig;gelijkwaardige;
onaangeroerd===onaangeroerd;
wrevelig===wrevelig;wreveliger;wreveligst;
aansluitend===aansluitend;aansluitende;
veralgemeend===veralgemeend;
ongerust===ongerust;
onduidelijk===onduidelijk;
doortrapt===doortrapt;doortrapter;doortraptst;
maligne===maligne;
ongelukkig===ongelukkig;
vrolijk===vrolijk;
schielijk===schielijk;schielijker;schielijkst;
ruw===ruw;
Kroatisch===Kroatisch;Kroatische;
vrijwillig===vrijwillig;vrijwilliger;
fiskaal===fiskaal;
giftig===giftig;
oppervlakkig===oppervlakkig;
aeroob===aeroob;
succesvol===succesvol;succesvolle;succesvoller;succesvolst;
opvoedkundig===opvoedkundig;opvoedkundige;
artificieel===artificieel;
waarneembaar===waarneembaar;
lief===lief;
teleologisch===teleologisch;
barbaars===barbaars;barbaarse;barbaarser;barbaarst;
oorspronkelijk===oorspronkelijk;oorspronkelijker;oorspronkelijkst;
roterend===roterend;
Grieks===Grieks;Griekse;
speels===speels;speelse;speelser;speelst;
winstgevend===winstgevend;
nuttig===nuttig;nuttige;
absoluut===absoluut;absolute;
zestigste===zestigste;
ongelegen===ongelegen;
verdomd===verdomd;
ondoordacht===ondoordacht;
etnisch===etnisch;etnische;
overbodig===overbodig;overbodige;overbodiger;overbodigs;overbodigst;
voorspoedig===voorspoedig;
konkreet===konkreet;
derde===derde;
waargebeurd===waargebeurd;
Silezisch===Silezisch;
rechts===rechts;
afgezaagd===afgezaagd;
eikenhouten===eikenhouten;
tweedehands===tweedehands;
achtste===achtste;
Filipijns===Filipijns;Filipijnse;
pril===pril;
slungelachtig===slungelachtig;
zachtmoedig===zachtmoedig;
cash===cash;
bewerkelijk===bewerkelijk;
gedetailleerd===gedetailleerd;
formeel===formeel;
administratief===administratief;
onomkeerbaar===onomkeerbaar;onomkeerbaarder;onomkeerbaars;onomkeerbaarst;onomkeerbare;
nationaal===nationaal;nationale;
crimineel===crimineel;crimineelst;criminele;crimineler;
onderst===onderst;onderste;
vast===vast;vaste;
ongeschreven===ongeschreven;
achtzaam===achtzaam;
onpraktisch===onpraktisch;
spiraalvormig===spiraalvormig;
klaarblijkelijk===klaarblijkelijk;klaarblijkelijke;klaarblijkelijker;klaarblijkelijks;klaarblijkelijkst;
brandbaar===brandbaar;
raadselachtig===raadselachtig;raadselachtige;raadselachtiger;
geëmotioneerd===geëmotioneerd;
diepvries===diepvries;
bankroet===bankroet;
Assamees===Assamees;
zielig===zielig;
biseksueel===biseksueel;
Nederfrankisch===Nederfrankisch;
bedachtzaam===bedachtzaam;
lyrisch===lyrisch;lyrische;lyrischer;lyrischt;
tegengesteld===tegengesteld;
zuidelijk===zuidelijk;zuidelijke;zuidelijker;
grootschalig===grootschalig;grootschalige;
Hollands===Hollands;Hollandse;Hollandser;Hollandst;
dubbelzinnig===dubbelzinnig;dubbelzinniger;dubbelzinnigst;
onbetaalbaar===onbetaalbaar;
volkomen===volkomen;
lila===lila;
genaamd===genaamd;
ander===ander;anders;
inheems===inheems;inheemse;
Pohnpeiaans===Pohnpeiaans;
meertalig===meertalig;meertalige;
globaal===globaal;globaalst;
glamoureus===glamoureus;glamoureuze;glamoureuzer;
onvoordelig===onvoordelig;
letterlijk===letterlijk;letterlijke;letterlijker;letterlijks;letterlijkst;
koppig===koppig;koppige;
vuurrood===vuurrood;
troebel===troebel;
exotisch===exotisch;exotische;
lijp===lijp;lijpe;
waardig===waardig;waardiger;waardigst;
binnenst===binnenst;binnenste;
toegestaan===toegestaan;toegestane;
link===link;linke;
Oekraïens===Oekraïens;Oekraïense;
afgekeurd===afgekeurd;
controversieel===controversieel;controversiële;
stoer===stoer;
aquatisch===aquatisch;aquatische;
apofatisch===apofatisch;
vroeger===vroeger;vroegere;
onvergelijkbaar===onvergelijkbaar;
verkeerd===verkeerd;verkeerde;
eigenaardig===eigenaardig;
ironisch===ironisch;ironische;
paramagnetisch===paramagnetisch;
aerodynamisch===aerodynamisch;
gerecht===gerecht;
gangbaar===gangbaar;gangbare;
rechtvaardig===rechtvaardig;
Austronesisch===Austronesisch;
jachtig===jachtig;jachtiger;jachtigst;
chronologisch===chronologisch;
lucratief===lucratief;lucratiefs;lucratiefst;lucratieve;lucratiever;
ongelovig===ongelovig;ongelovige;
Zuid-Afrikaans===Zuid-Afrikaans;
metafysisch===metafysisch;metafysische;
Peruaans===Peruaans;Peruaanse;
plenair===plenair;
verwerpelijk===verwerpelijk;
surreëel===surreëel;
voedselrijk===voedselrijk;
bestuurlijk===bestuurlijk;bestuurlijke;
groenblijvend===groenblijvend;groenblijvende;groenblijvends;
schreefloos===schreefloos;
dierlijk===dierlijk;dierlijke;
onrecht===onrecht;onrechte;
onjuist===onjuist;
benedenwinds===benedenwinds;
erotisch===erotisch;
Bosnisch===Bosnisch;Bosnischer;Bosnischt;
dwars===dwars;dwarse;
Indo-Europees===Indo-Europees;Indo-Europese;
eucharistisch===eucharistisch;
Palestijns===Palestijns;
maximaal===maximaal;maximaalst;
preuts===preuts;
cryogenisch===cryogenisch;
automatisch===automatisch;automatische;
tureluurs===tureluurs;
zogenoemd===zogenoemd;
doorgedraaid===doorgedraaid;
dactyloscopisch===dactyloscopisch;
stemplichtig===stemplichtig;
afdoend===afdoend;
vindingrijk===vindingrijk;vindingrijke;vindingrijker;vindingrijks;vindingrijkst;
inclusief===inclusief;inclusieve;
onuitrekbaar===onuitrekbaar;
transseksueel===transseksueel;transseksueels;transseksueelst;transseksuele;transseksueler;
pro-actief===pro-actief;
expliciet===expliciet;explicieter;explicietst;
doodgeboren===doodgeboren;
eivormig===eivormig;eivormige;eivormiger;eivormigs;eivormigst;
roekeloos===roekeloos;
overig===overig;overige;
geduldig===geduldig;
achturig===achturig;
defensief===defensief;defensiefst;defensieve;defensiever;
begrijpelijk===begrijpelijk;
wederrechtelijk===wederrechtelijk;
Laotiaans===Laotiaans;
merkwaardig===merkwaardig;merkwaardige;merkwaardiger;merkwaardigst;
kil===kil;
loepzuiver===loepzuiver;
invalide===invalide;
onopvallend===onopvallend;onopvallende;
verstandig===verstandig;verstandiger;verstandigst;
ruimteziek===ruimteziek;
gedachteloos===gedachteloos;gedachteloost;gedachteloze;gedachtelozer;
beeldend===beeldend;beeldende;
aanvaardbaar===aanvaardbaar;
geestdriftig===geestdriftig;
betwist===betwist;
vies===vies;viest;
drammerig===drammerig;drammeriger;drammerigst;
legitiem===legitiem;legitiemer;legitiemst;
hervormd===hervormd;hervormde;
internationaal===internationaal;internationaalst;internationale;internationaler;
reflecterend===reflecterend;reflecterende;
achttiende===achttiende;
verdedigbaar===verdedigbaar;
hedendaags===hedendaags;
gedeeltelijk===gedeeltelijk;gedeeltelijke;
noodzakelijk===noodzakelijk;noodzakelijke;noodzakelijker;noodzakelijks;noodzakelijkst;
rechtmatig===rechtmatig;rechtmatiger;rechtmatigst;
siderisch===siderisch;siderische;
steil===steil;steile;steiler;steilst;
verstandelijk===verstandelijk;
paranoïde===paranoïde;
particulier===particulier;
Noors===Noors;
integer===integer;integere;integers;
franco===franco;
onstuimig===onstuimig;onstuimige;onstuimiger;onstuimigs;onstuimigst;
langgerekt===langgerekt;
gotisch===gotisch;
vernietigd===vernietigd;vernietigde;
vrijgesteld===vrijgesteld;
geruim===geruim;
gebukt===gebukt;
paraconsistent===paraconsistent;
geruit===geruit;geruite;
aantonend===aantonend;aantonende;
wettelijk===wettelijk;wettelijker;wettelijkst;
verwijtbaar===verwijtbaar;
kruislings===kruislings;kruislingse;
antiek===antiek;
onherbergzaam===onherbergzaam;
uitdagend===uitdagend;
ludiek===ludiek;ludieker;ludiekst;
kwaad===kwaad;kwaadst;
aanvankelijk===aanvankelijk;aanvankelijke;
digestief===digestief;
verhit===verhit;
langzaam===langzaam;langzaams;langzaamst;langzame;
gereed===gereed;
agnostisch===agnostisch;
schromelijk===schromelijk;
tevreden===tevreden;tevree;
levenslang===levenslang;levenslange;
homogeen===homogeen;homogene;
ongemout===ongemout;
bezorgd===bezorgd;bezorgde;bezorgder;bezorgds;bezorgdst;
vochtig===vochtig;vochtige;
ambitieus===ambitieus;ambitieust;ambitieuze;ambitieuzer;
onhandig===onhandig;onhandige;
authentiek===authentiek;authentieke;
Vietnamees===Vietnamees;
oorlogvoerend===oorlogvoerend;
fatisch===fatisch;
ongekoperd===ongekoperd;
hellenistisch===hellenistisch;
roestvrij===roestvrij;
gevorderd===gevorderd;
besmuikt===besmuikt;besmuikter;
vaardig===vaardig;
hoeveelste===hoeveelste;
onverschrokken===onverschrokken;onverschrokkener;onverschrokkenst;
amechtig===amechtig;amechtiger;amechtigst;
rossig===rossig;rossige;rossiger;rossigs;rossigst;
aartsvaderlijk===aartsvaderlijk;
westelijk===westelijk;westelijke;
vrij===vrij;vrije;
verwaarloosbaar===verwaarloosbaar;verwaarloosbare;
toeter===toeter;
verborgen===verborgen;
reusachtig===reusachtig;reusachtige;
figuratief===figuratief;
kortelings===kortelings;
verdrietig===verdrietig;
forensisch===forensisch;forensische;
pyknisch===pyknisch;
gastvrij===gastvrij;
zwak===zwak;
entomologisch===entomologisch;
sexy===sexy;
minimaal===minimaal;minimale;
ongeremd===ongeremd;
peperduur===peperduur;peperdure;peperduurs;
waar===waar;
heftig===heftig;
rotsachtig===rotsachtig;
structureel===structureel;structurele;
spa===spa;
verteerbaar===verteerbaar;verteerbaarder;verteerbaarst;
belangrijk===belangrijk;belangrijke;belangrijker;belangrijkst;
bedompt===bedompt;
braaf===braaf;braafst;
toekomend===toekomend;toekomende;toekomends;
symptomatisch===symptomatisch;
goochem===goochem;
accuraat===accuraat;accurate;
evangelisch===evangelisch;
onverdraagzaam===onverdraagzaam;onverdraagzaamst;onverdraagzamer;
Turkmeens===Turkmeens;
hondachtig===hondachtig;hondachtige;hondachtiger;hondachtigs;hondachtigst;
kubiek===kubiek;
Caribisch===Caribisch;
christelijk===christelijk;
dimensionaal===dimensionaal;
nipt===nipt;nipte;
poëtisch===poëtisch;
ondoorzichtig===ondoorzichtig;ondoorzichtige;
aanmerkelijk===aanmerkelijk;
beweegbaar===beweegbaar;
gelijktonig===gelijktonig;
wijdverspreid===wijdverspreid;wijdverspreide;
overdrachtelijk===overdrachtelijk;
sterk===sterk;sterke;sterker;sterkst;
zuinig===zuinig;zuinige;zuiniger;zuinigst;
kol===kol;
commercieel===commercieel;
volwassen===volwassen;
ontroerend===ontroerend;
drukbaar===drukbaar;
ongerept===ongerept;
tijdelijk===tijdelijk;tijdelijke;
samenwerkend===samenwerkend;
Karelisch===Karelisch;
pontificaal===pontificaal;pontificale;
impertinent===impertinent;
verkiesbaar===verkiesbaar;
openbaar===openbaar;openbare;
impliciet===impliciet;implicieter;implicietst;
vriendelijk===vriendelijk;vriendelijke;vriendelijker;vriendelijkst;
Tsjechisch===Tsjechisch;
bruusk===bruusk;bruusker;bruuskst;
planmatig===planmatig;planmatiger;planmatigst;
bisschoppelijk===bisschoppelijk;
haveloos===haveloos;haveloost;haveloze;
variabel===variabel;
echter===echter;echtere;echters;
kwalijk===kwalijk;kwalijke;kwalijker;kwalijks;kwalijkst;
genadig===genadig;genadige;genadiger;genadigs;genadigst;
Venetiaans===Venetiaans;
regionaal===regionaal;regionale;
spontaan===spontaan;spontaanst;
verbaasd===verbaasd;
Koreaans===Koreaans;
verdraagzaam===verdraagzaam;verdraagzaamst;verdraagzamer;
wereldlijk===wereldlijk;
equivalent===equivalent;equivalente;
aangeslagen===aangeslagen;
scherp===scherp;scherpe;scherper;scherps;scherpst;
loyaal===loyaal;loyaalst;
besloten===besloten;
barok===barok;barokke;
proactief===proactief;
vragelijk===vragelijk;
overmoedig===overmoedig;
zuiver===zuiver;zuivere;zuiverst;
abstract===abstract;abstracte;
barmhartig===barmhartig;barmhartige;barmhartiger;barmhartigst;
koffer===koffer;koffers;
verwoed===verwoed;verwoede;
ketters===ketters;
strijdvaardig===strijdvaardig;strijdvaardiger;strijdvaardigst;
votief===votief;votieve;
verdienstelijk===verdienstelijk;
veroordeeld===veroordeeld;veroordeelde;
theatraal===theatraal;theatraals;theatraalst;theatrale;theatraler;
voorvaderlijk===voorvaderlijk;
elastisch===elastisch;
waterpas===waterpas;
werkeloos===werkeloos;
Kirgizisch===Kirgizisch;
begerig===begerig;begerige;begeriger;begerigs;begerigst;
nadrukkelijk===nadrukkelijk;nadrukkelijker;nadrukkelijkst;
heteroseksueel===heteroseksueel;
memorabel===memorabel;
drastisch===drastisch;drastische;
onomstotelijk===onomstotelijk;onomstotelijke;
socialistisch===socialistisch;socialistische;socialistischer;socialistischt;
enorm===enorm;enorme;
egoïstisch===egoïstisch;
ongezien===ongezien;ongeziene;
zelfrijzend===zelfrijzend;
emotioneel===emotioneel;emotioneelst;emotionele;emotioneler;
onachtzaam===onachtzaam;
overgeleverd===overgeleverd;overgeleverde;
omzichtig===omzichtig;omzichtiger;omzichtigst;
ivoren===ivoren;
onberispelijk===onberispelijk;
schuin===schuin;
angstig===angstig;angstiger;angstigst;
ouderwets===ouderwets;ouderwetse;ouderwetser;
piemelnaakt===piemelnaakt;
zondig===zondig;
potig===potig;
perifeer===perifeer;perifere;
leerzaam===leerzaam;leerzaamst;
baanbrekend===baanbrekend;baanbrekende;
beheerst===beheerst;
geestelijk===geestelijk;geestelijke;geestelijker;geestelijkst;
hemelblauw===hemelblauw;
kompres===kompres;
loops===loops;
avontuurlijk===avontuurlijk;
ondrinkbaar===ondrinkbaar;ondrinkbare;
direct===direct;
later===later;latere;
pragmatisch===pragmatisch;pragmatischer;
ingezet===ingezet;ingezette;
onoverbrugbaar===onoverbrugbaar;
tweevoetig===tweevoetig;
zachtzinnig===zachtzinnig;zachtzinniger;zachtzinnigst;
alleenstaand===alleenstaand;alleenstaande;
klam===klam;klams;
onbeheerst===onbeheerst;
stiekem===stiekem;stiekeme;
alomtegenwoordig===alomtegenwoordig;
donkerrood===donkerrood;
biografisch===biografisch;
initieel===initieel;initieels;
boud===boud;
passioneel===passioneel;
enigst===enigst;enigste;
bereikbaar===bereikbaar;bereikbaarder;bereikbaarst;
valide===valide;
beheerbaar===beheerbaar;
executief===executief;executieve;
vastberaden===vastberaden;
jaarlijks===jaarlijks;jaarlijkse;
heuristisch===heuristisch;
steengoed===steengoed;
ongekend===ongekend;
slobberig===slobberig;slobberiger;slobberigst;
komiek===komiek;komieke;komieker;komieks;komiekst;
voltooid===voltooid;
almachtig===almachtig;almachtiger;almachtigst;
onbekend===onbekend;onbekende;
grafisch===grafisch;grafische;
cyrillisch===cyrillisch;
pokdalig===pokdalig;
suf===suf;
imaginair===imaginair;imaginaire;
kwaadaardig===kwaadaardig;
revolutionair===revolutionair;revolutionaire;
Arabisch===Arabisch;Arabische;
verwrongen===verwrongen;
spiksplinternieuw===spiksplinternieuw;
gelijknamig===gelijknamig;
Egyptisch===Egyptisch;
rein===rein;reine;reins;
keizerlijk===keizerlijk;
testamentair===testamentair;testamentaire;
onscheidbaar===onscheidbaar;
grof===grof;grofs;
nabij===nabij;
typerend===typerend;
lofwaardig===lofwaardig;
omgekeerd===omgekeerd;
agressief===agressief;agressiefs;agressiefst;agressieve;agressiever;
menschelijk===menschelijk;
zichtbaar===zichtbaar;zichtbare;
gortig===gortig;gortige;gortiger;gortigs;gortigst;
nadelig===nadelig;nadelige;
blind===blind;blinde;
betwistbaar===betwistbaar;
uitvoerend===uitvoerend;uitvoerende;
slagvaardig===slagvaardig;
gesmeerd===gesmeerd;
plomp===plomp;plompe;plomper;plomps;plompst;
oeroud===oeroud;
deerniswekkend===deerniswekkend;
scheef===scheef;scheefst;schever;
beduidend===beduidend;beduidende;
infernaal===infernaal;
scheel===scheel;
kinderlijk===kinderlijk;
gemaakt===gemaakt;
subtropisch===subtropisch;
mindervalide===mindervalide;
kinetisch===kinetisch;kinetische;
prikkelbaar===prikkelbaar;
vastvoetig===vastvoetig;
bovenst===bovenst;bovenste;
gebruikelijk===gebruikelijk;gebruikelijke;gebruikelijker;gebruikelijks;gebruikelijkst;
donkerblauw===donkerblauw;donkerblauwer;donkerblauwst;
gedwee===gedwee;gedweest;gedweeë;gedweeër;
zout===zout;zoute;
deskundig===deskundig;deskundige;deskundiger;deskundigst;
tam===tam;tams;
vaderlijk===vaderlijk;vaderlijke;
vermeten===vermeten;
doodsbang===doodsbang;
doorslaggevend===doorslaggevend;doorslaggevende;
vermetel===vermetel;
elektrostatisch===elektrostatisch;
vervlogen===vervlogen;
vierde===vierde;
geneeskrachtig===geneeskrachtig;
voortgezet===voortgezet;voortgezette;
wijlen===wijlen;
Russisch===Russisch;Russische;
Glagolitisch===Glagolitisch;
neerslachtig===neerslachtig;
infantiel===infantiel;
levensmoe===levensmoe;levensmoest;levensmoeër;
edel===edel;edele;
genegen===genegen;genegener;genegenst;
lijfeigen===lijfeigen;
verfomfaaid===verfomfaaid;
ootmoedig===ootmoedig;
regelbaar===regelbaar;regelbare;
uitgebracht===uitgebracht;uitgebrachte;
joviaal===joviaal;
ambtelijk===ambtelijk;
twijfelachtig===twijfelachtig;twijfelachtiger;twijfelachtigst;
regelrecht===regelrecht;
levensbelangrijk===levensbelangrijk;
huiveringwekkend===huiveringwekkend;
mogelijk===mogelijk;
sikkeneurig===sikkeneurig;sikkeneurige;sikkeneuriger;sikkeneurigs;sikkeneurigst;
Moskovisch===Moskovisch;Moskovische;
langgerokt===langgerokt;
stug===stug;
stuk===stuk;
diep===diep;diepe;dieps;
surjectief===surjectief;
ruis===ruis;rus;
glashelder===glashelder;
schatplichtig===schatplichtig;
centrifugaal===centrifugaal;centrifugaals;centrifugale;
roerloos===roerloos;
ruim===ruim;
ruig===ruig;ruige;ruigs;
voormalig===voormalig;voormalige;
berucht===berucht;beruchte;beruchter;beruchtst;
anarchistisch===anarchistisch;
gevreesd===gevreesd;
wanordelijk===wanordelijk;
katholiek===katholiek;katholieke;
vermoedelijk===vermoedelijk;vermoedelijke;
Kasjoebisch===Kasjoebisch;
linker===linker;linkere;
netelig===netelig;
ergerlijk===ergerlijk;ergerlijke;ergerlijker;ergerlijks;ergerlijkst;
volmaakt===volmaakt;
grammaticaal===grammaticaal;grammaticale;
lichamelijk===lichamelijk;
onvoltooid===onvoltooid;
embryonaal===embryonaal;embryonale;
bovengistend===bovengistend;
meerlettergrepig===meerlettergrepig;
onoplettend===onoplettend;
ouderloos===ouderloos;
sneu===sneu;
bont===bont;
warm===warm;warme;
snel===snel;
weloverwogen===weloverwogen;
bijwoordelijk===bijwoordelijk;
jammer===jammer;
piramidaal===piramidaal;piramidaals;piramidaalst;piramidale;piramidaler;
hevig===hevig;hevige;
ernstig===ernstig;ernstige;ernstiger;ernstigs;ernstigst;
gretig===gretig;gretige;gretiger;gretigs;gretigst;
rectaal===rectaal;
stoutmoedig===stoutmoedig;
volmondig===volmondig;
boos===boos;
makkelijk===makkelijk;makkelijke;makkelijker;makkelijkst;
geleed===geleed;
prestigieus===prestigieus;prestigieuze;
Jiddisch===Jiddisch;
onderdanig===onderdanig;
welriekend===welriekend;
voordelig===voordelig;voordeliger;
voorbeeldig===voorbeeldig;
relatief===relatief;relatieve;
venijnig===venijnig;
stelselmatig===stelselmatig;
wellevend===wellevend;
zilverkleurig===zilverkleurig;zilverkleurige;
aardewerken===aardewerken;
belachelijk===belachelijk;belachelijke;belachelijker;belachelijkst;
barotroop===barotroop;
verraderlijk===verraderlijk;
glaciaal===glaciaal;
huisgemaakt===huisgemaakt;huisgemaakte;
onethisch===onethisch;onethischer;
gigantisch===gigantisch;gigantische;
Maltees===Maltees;
typisch===typisch;typische;
tegenstrijdig===tegenstrijdig;
bevoogdend===bevoogdend;bevoogdender;bevoogdendst;
waakzaam===waakzaam;waakzaamst;
ritueel===ritueel;rituele;
overvol===overvol;
klimatologisch===klimatologisch;klimatologische;
stichtelijk===stichtelijk;
bitter===bitter;bitterst;
plebeïsch===plebeïsch;
gelijkzijdig===gelijkzijdig;
overdreven===overdreven;
fundamenteel===fundamenteel;fundamentele;
zorgzaam===zorgzaam;zorgzaamst;zorgzame;
invers===invers;inverse;
jongdement===jongdement;
donkergrijs===donkergrijs;
driftig===driftig;driftiger;driftigst;
levenskrachtig===levenskrachtig;levenskrachtige;levenskrachtiger;levenskrachtigs;levenskrachtigst;
breedbeeld===breedbeeld;
marginaal===marginaal;
rampzalig===rampzalig;rampzalige;rampzaliger;rampzaligst;
genereus===genereus;genereust;genereuzer;
aangelegen===aangelegen;
verward===verward;verwarde;
stil===stil;
toornig===toornig;toornige;
gewichtloos===gewichtloos;
onafhankelijk===onafhankelijk;
rotsig===rotsig;
discreet===discreet;
amorf===amorf;
uitstekend===uitstekend;uitstekende;
bol===bol;
twaalfde===twaalfde;
gemoedelijk===gemoedelijk;
puitebloot===puitebloot;
Veluws===Veluws;
vlekkeloos===vlekkeloos;
draaierig===draaierig;draaieriger;draaierigst;
proletarisch===proletarisch;
favoriet===favoriet;favoriete;
soporeus===soporeus;
archaïsch===archaïsch;archaïsche;
nauwkeurig===nauwkeurig;nauwkeurige;nauwkeuriger;nauwkeurigs;nauwkeurigst;
behaagziek===behaagziek;behaagzieker;behaagziekst;
veilig===veilig;veiliger;veiligst;
glasachtig===glasachtig;
beleefd===beleefd;beleefde;
secundair===secundair;secundaire;
vettig===vettig;
foeilelijk===foeilelijk;foeilelijker;foeilelijkst;
roemruchtig===roemruchtig;
windwaarts===windwaarts;
kunstzinnig===kunstzinnig;kunstzinniger;kunstzinnigst;
wollen===wollen;
gezet===gezet;gezette;
bizar===bizar;bizarre;bizarst;
broodmager===broodmager;broodmagere;
achteloos===achteloos;
gevuld===gevuld;gevulde;
desastreus===desastreus;desastreust;desastreuzer;
normaal===normaal;
wollig===wollig;wolliger;wolligst;
verkrijgbaar===verkrijgbaar;verkrijgbaars;verkrijgbare;
democratisch===democratisch;democratische;democratischer;democratischt;
tweebaans===tweebaans;
verwant===verwant;
ijzingwekkend===ijzingwekkend;
voorlopig===voorlopig;voorlopige;voorlopiger;voorlopigs;voorlopigst;
zijden===zijden;
orgastisch===orgastisch;
meticuleus===meticuleus;meticuleust;meticuleuze;meticuleuzer;
onbezonnen===onbezonnen;
vormeloos===vormeloos;
ongeduldig===ongeduldig;ongeduldiger;ongeduldigst;
bestendig===bestendig;bestendiger;bestendigst;
stom===stom;
zeepachtig===zeepachtig;
doodeenvoudig===doodeenvoudig;doodeenvoudiger;doodeenvoudigst;
terugwaarts===terugwaarts;
ongewoon===ongewoon;ongewone;ongewoons;ongewoonst;
levend===levend;levende;
ongeletterd===ongeletterd;ongeletterde;
inauguraal===inauguraal;inaugureel;
bot===bot;
vreugdeloos===vreugdeloos;
abnormaal===abnormaal;abnormale;
droger===droger;drogere;
stokoud===stokoud;stokouder;stokoudst;
zat===zat;
hel===hel;
erbarmelijk===erbarmelijk;erbarmelijker;erbarmelijkst;
gezocht===gezocht;
flauw===flauw;flauwer;flauwst;
onafgewerkt===onafgewerkt;
zot===zot;
langbenig===langbenig;
verlokkelijk===verlokkelijk;
waanzinnig===waanzinnig;waanzinnige;waanzinniger;waanzinnigst;
wulps===wulps;wulpser;wulpst;
tertiair===tertiair;
onverhoopt===onverhoopt;
teer===teer;
Mexicaans===Mexicaans;Mexicaanse;Mexicaanser;Mexicaanst;
eenparig===eenparig;eenparige;eenpariger;eenparigs;eenparigst;
zelfverzekerd===zelfverzekerd;zelfverzekerde;zelfverzekerder;zelfverzekerds;zelfverzekerdst;
modaal===modaal;
onaangenaam===onaangenaam;onaangenaamst;onaangename;onaangenamer;
schimmig===schimmig;
bar===bar;
stoffelijk===stoffelijk;stoffelijke;
gratis===gratis;
eenduidig===eenduidig;
ontstaan===ontstaan;ontstane;
aristocratisch===aristocratisch;
demonteerbaar===demonteerbaar;
landelijk===landelijk;landelijke;
kuis===kuis;kuise;
aromatisch===aromatisch;aromatische;
boosaardig===boosaardig;boosaardiger;boosaardigst;
star===star;
vijandig===vijandig;vijandige;
unaniem===unaniem;
loodrecht===loodrecht;
ongenaakbaar===ongenaakbaar;
slecht===slecht;slechte;slechter;
negatief===negatief;negatiefst;negatieve;negatiever;
opgescheept===opgescheept;
aangrijpend===aangrijpend;aangrijpende;
betrouwbaar===betrouwbaar;betrouwbare;
zinnelijk===zinnelijk;
aanvoegend===aanvoegend;aanvoegende;
schriftelijk===schriftelijk;schriftelijke;
hebzuchtig===hebzuchtig;
rustiek===rustiek;
zijdelings===zijdelings;zijdelingse;
geodetisch===geodetisch;geodetische;
evolutionair===evolutionair;evolutionaire;evolutionairs;
helderziend===helderziend;
trefzeker===trefzeker;
vreesachtig===vreesachtig;vreesachtige;vreesachtiger;vreesachtigs;vreesachtigst;
treurigmakend===treurigmakend;treurigmakende;
gelijkvloers===gelijkvloers;
schandalig===schandalig;schandaliger;schandaligst;
modernistisch===modernistisch;modernistische;
gemeenzaam===gemeenzaam;gemeenzaams;gemeenzaamst;gemeenzame;gemeenzamer;
spreekwoordelijk===spreekwoordelijk;
uitnemend===uitnemend;uitnemende;
betrekkelijk===betrekkelijk;
vulgair===vulgair;vulgairder;vulgaire;vulgairst;
Tanzaniaans===Tanzaniaans;Tanzaniaanse;
onuitwisbaar===onuitwisbaar;onuitwisbaarder;onuitwisbaarst;
stompzinnig===stompzinnig;stompzinniger;stompzinnigst;
radeloos===radeloos;
ontzachelĳk===ontzachelĳk;
geblinddoekt===geblinddoekt;
bladvormig===bladvormig;
Occitaans===Occitaans;
omkeerbaar===omkeerbaar;omkeerbaarder;omkeerbaars;omkeerbaarst;omkeerbare;
kubistisch===kubistisch;
bodemloos===bodemloos;
moeizaam===moeizaam;moeizaams;moeizaamst;moeizame;
bepaald===bepaald;bepaalde;
nauw===nauw;nauwe;
wazig===wazig;
bloot===bloot;bloots;blootst;
schattig===schattig;
onhandelbaar===onhandelbaar;onhandelbaarder;onhandelbaars;onhandelbaarst;onhandelbare;
onterecht===onterecht;onterechte;onterechter;onterechts;onterechtst;
plat===plat;
vervaarlijk===vervaarlijk;
initiaal===initiaal;
eponiem===eponiem;
kwiek===kwiek;
grijs===grijs;grijst;
nevelig===nevelig;nevelige;neveliger;neveligs;neveligst;
Vlaams===Vlaams;
consistent===consistent;consistente;
nietszeggend===nietszeggend;
blond===blond;blonde;
adagio===adagio;
gescheiden===gescheiden;
onherstelbaar===onherstelbaar;
afzinkbaar===afzinkbaar;afzinkbare;
Duitstalig===Duitstalig;Duitstalige;
kenbaar===kenbaar;
Welsh===Welsh;
ijdel===ijdel;
euvel===euvel;
marineblauw===marineblauw;
middelbaar===middelbaar;
inhalig===inhalig;
conflictueus===conflictueus;
viskeus===viskeus;
zelfstandig===zelfstandig;
aanvallend===aanvallend;aanvallende;aanvallender;aanvallendst;
grasgroen===grasgroen;
gulden===gulden;
belabberd===belabberd;
gezind===gezind;gezinde;
behoedzaam===behoedzaam;behoedzaamst;behoedzamer;
vlijtig===vlijtig;vlijtiger;vlijtigst;
elizabethaans===elizabethaans;elizabethaanse;
centraal===centraal;
gedroogd===gedroogd;
medeplichtig===medeplichtig;medeplichtige;
complex===complex;complexe;complexer;complext;
welig===welig;weliger;weligst;
kapitalistisch===kapitalistisch;kapitalistische;
staatkundig===staatkundig;staatkundiger;staatkundigst;
zevende===zevende;
bruikbaar===bruikbaar;
strafbaar===strafbaar;
best===best;beste;
verregaand===verregaand;verregaande;
melodieus===melodieus;melodieust;melodieuze;melodieuzer;
planetair===planetair;planetaire;
Amerikaans===Amerikaans;Amerikaanse;Amerikaanser;Amerikaanst;
vlezig===vlezig;
vreedzaam===vreedzaam;vreedzaams;vreedzaamst;vreedzame;vreedzamer;
extrusief===extrusief;extrusieve;
precolumbiaans===precolumbiaans;
roestig===roestig;
down===down;
onophoudend===onophoudend;
week===week;
essentieel===essentieel;essentiële;
asymmetrisch===asymmetrisch;
aannemelijk===aannemelijk;aannemelijke;aannemelijker;aannemelijks;aannemelijkst;
bovenvermeld===bovenvermeld;
branden===branden;brandend;
Atheens===Atheens;
listig===listig;listiger;listigst;
gerechtelijk===gerechtelijk;gerechtelijke;
bevooroordeeld===bevooroordeeld;
goedaardig===goedaardig;
meedogenloos===meedogenloos;
gewestelijk===gewestelijk;
krijgshaftig===krijgshaftig;
caritatief===caritatief;caritatiefst;caritatieve;caritatiever;
kwijt===kwijt;
straf===straf;straffe;strafst;
precies===precies;preciest;precieze;
strak===strak;strakke;strakst;
halfslachtig===halfslachtig;
gewapend===gewapend;gewapende;
neurotisch===neurotisch;
hardvochtig===hardvochtig;
gelaagd===gelaagd;gelaagde;
driedimensionaal===driedimensionaal;driedimensionale;
ontevreden===ontevreden;
kosmopolitisch===kosmopolitisch;
splinternieuw===splinternieuw;splinternieuwe;
Noords===Noords;
stuntelig===stuntelig;
uitgebreid===uitgebreid;uitgebreide;uitgebreider;uitgebreids;uitgebreidst;
werkzaam===werkzaam;werkzaams;werkzaamst;werkzame;
welkom===welkom;
overzichtelijk===overzichtelijk;
ongewijzigd===ongewijzigd;
vrijzinnig===vrijzinnig;
zwijgzaam===zwijgzaam;zwijgzame;
Mesopotamisch===Mesopotamisch;
goor===goor;
orthogonaal===orthogonaal;
mistroostig===mistroostig;
Boliviaans===Boliviaans;Boliviaanse;Boliviaanser;Boliviaanst;
kenmerkend===kenmerkend;kenmerkende;
bloen===bloen;
aandachtig===aandachtig;
vijandelijk===vijandelijk;
bijkomstig===bijkomstig;bijkomstiger;bijkomstigst;
gul===gul;
vergevorderd===vergevorderd;
eclectisch===eclectisch;eclectische;
nerveus===nerveus;
welbemind===welbemind;welbeminde;
roodachtig===roodachtig;roodachtige;
gestreng===gestreng;
academisch===academisch;academische;
ingrijpend===ingrijpend;
soeverein===soeverein;
hoteldebotel===hoteldebotel;
gipsen===gipsen;
meinedig===meinedig;
seculier===seculier;seculiere;
hondsdol===hondsdol;
onbruikbaar===onbruikbaar;onbruikbaarder;onbruikbaars;onbruikbaarst;onbruikbare;
rechter===rechter;rechtere;
stuurbaar===stuurbaar;
rigoureus===rigoureus;rigoreus;rigoureust;rigoureuze;rigoureuzer;
seksueel===seksueel;
naar===naar;
postuum===postuum;postume;postuums;
paars===paars;paarse;paarser;paarst;
tweevoudig===tweevoudig;
volks===volks;volkse;volkser;volkst;
foetsie===foetsie;
onderhevig===onderhevig;
onsamenhangend===onsamenhangend;
zogenaamd===zogenaamd;zogenaamde;
primair===primair;primaire;
Soedanees===Soedanees;
aardewerk===aardewerk;
negentiende===negentiende;
meetbaar===meetbaar;
kunstig===kunstig;kunstiger;kunstigst;
oneindig===oneindig;
pratatief===pratatief;
legaal===legaal;legaalst;
vaginaal===vaginaal;
onschendbaar===onschendbaar;
malloot===malloot;
serieus===serieus;serieust;serieuze;
onvermoeibaar===onvermoeibaar;
gapend===gapend;
remonstrants===remonstrants;
koortsig===koortsig;
biologisch===biologisch;
verdacht===verdacht;
geblindeerd===geblindeerd;geblindeerde;
eventueel===eventueel;eventuele;
garstig===garstig;garstige;garstiger;garstigs;garstigst;
betekenisvol===betekenisvol;
herkenbaar===herkenbaar;herkenbare;
milieuvriendelijk===milieuvriendelijk;milieuvriendelijker;milieuvriendelijkst;
Nedersaksisch===Nedersaksisch;
verstrekkend===verstrekkend;
resterend===resterend;resterende;
onverschillig===onverschillig;
onaanvaardbaar===onaanvaardbaar;onaanvaardbare;
anoniem===anoniem;anonieme;
topografisch===topografisch;topografische;
Keltisch===Keltisch;
teleurstellend===teleurstellend;
botanisch===botanisch;botanische;
Atlantisch===Atlantisch;Atlantische;
donkerbruin===donkerbruin;
stormachtig===stormachtig;stormachtiger;stormachtigst;
afzonderlijk===afzonderlijk;afzonderlijke;
plaatselijk===plaatselijk;plaatselijke;
gabardine===gabardine;
arrogant===arrogant;
obsessief===obsessief;obsessieve;
gehecht===gehecht;
extreem===extreem;extreems;extreemst;extreme;extremer;
stedewaarts===stedewaarts;
razendsnel===razendsnel;razendsnelle;
ideaal===ideaal;ideaalst;
wanhopig===wanhopig;wanhopige;
snikheet===snikheet;snikheetst;snikheter;
voornaam===voornaam;voornaamst;
verkleumd===verkleumd;
apodictisch===apodictisch;apodictische;
dankloos===dankloos;
onverteerbaar===onverteerbaar;onverteerbaarder;onverteerbaarst;
mooi===mooi;mooie;moois;
gewenst===gewenst;
ongewis===ongewis;ongewisser;
redelijk===redelijk;redelijke;redelijker;redelijks;redelijkst;
wetenschappelijk===wetenschappelijk;wetenschappelijke;wetenschappelijker;wetenschappelijks;wetenschappelijkst;
dwarsliggend===dwarsliggend;
alleen===alleen;
bedroefd===bedroefd;
zuidwestelijk===zuidwestelijk;zuidwestelijke;zuidwestelijker;zuidwestelijkst;
ouder===ouder;oudere;
wereldwijd===wereldwijd;
knus===knus;knust;
leip===leip;leipe;
gewaagd===gewaagd;
erfelijk===erfelijk;erfelijke;
lenig===lenig;leniger;lenigst;
psychisch===psychisch;
dertien-in-een-dozijn===dertien-in-een-dozijn;
verbogen===verbogen;verbogene;
struikvormig===struikvormig;
Argentijns===Argentijns;Argentijnse;Argentijnser;Argentijnst;
excellent===excellent;
korstvormig===korstvormig;
gemakkelijk===gemakkelijk;gemakkelijke;gemakkelijker;gemakkelijkst;
zinloos===zinloos;zinloost;
loos===loos;loost;
gecompliceerd===gecompliceerd;gecompliceerde;gecompliceerder;gecompliceerds;gecompliceerdst;
onmannelijk===onmannelijk;onmannelijke;
loom===loom;
onbedoeld===onbedoeld;onbedoelde;
fluwelen===fluwelen;
lesbisch===lesbisch;
Corsicaans===Corsicaans;Corsicaanser;Corsicaanst;
afgeleefd===afgeleefd;
spiernaakt===spiernaakt;
dapper===dapper;dappere;dapperst;
paal===paal;
klastisch===klastisch;
fantastisch===fantastisch;fantastische;fantastischer;fantastischt;
fascistisch===fascistisch;
pervers===pervers;perverse;perverser;perverst;
gier===gier;
denkbeeldig===denkbeeldig;
speelbaar===speelbaar;
conservatief===conservatief;conservatiefst;conservatiever;
heidens===heidens;
civiel===civiel;civiele;civieler;civiels;civielst;
pedofiel===pedofiel;
iel===iel;
klassiek===klassiek;klassieke;
heimelijk===heimelijk;heimelijke;heimelijker;heimelijks;heimelijkst;
ongenadig===ongenadig;ongenadige;ongenadiger;ongenadigs;ongenadigst;
dubbel===dubbel;dubbele;
kwaadwillend===kwaadwillend;
groots===groots;grootse;grootser;grootst;
lomp===lomp;lompe;lomps;
bi===bi;
Egeïsch===Egeïsch;
elektrisch===elektrisch;elektrische;
vervloekt===vervloekt;
origineel===origineel;
rumoerig===rumoerig;rumoerige;
indrukwekkend===indrukwekkend;indrukwekkender;indrukwekkendst;
ontroerd===ontroerd;
kosmisch===kosmisch;kosmische;
lens===lens;
gewetenloos===gewetenloos;gewetenloost;gewetenlozer;
beducht===beducht;beduchte;beduchter;beduchts;beduchtst;
veeleisend===veeleisend;
onleesbaar===onleesbaar;onleesbare;
episcopaal===episcopaal;
verzot===verzot;
waarschijnlijk===waarschijnlijk;waarschijnlijker;waarschijnlijkst;
geneeslijk===geneeslijk;
stomp===stomp;
langdurig===langdurig;
voedselarm===voedselarm;
Fenicisch===Fenicisch;
houtachtig===houtachtig;
intrusief===intrusief;
mager===mager;
onderaards===onderaards;
beige===beige;
achttienjarig===achttienjarig;achttienjarige;
banaal===banaal;banaalst;
politiek===politiek;politieke;politieks;
geelgroen===geelgroen;
onwettelijk===onwettelijk;onwettelijker;onwettelijkst;
calorisch===calorisch;
feilloos===feilloos;feilloost;
vergankelijk===vergankelijk;
ongebruikelijk===ongebruikelijk;
blauwogig===blauwogig;
draaglijk===draaglijk;
af===af;
geslaagd===geslaagd;geslaagde;
muisstil===muisstil;
doof===doof;
dood===dood;
Katangees===Katangees;
biochemisch===biochemisch;
saai===saai;saaie;saais;
toxicologisch===toxicologisch;
correct===correct;
plaatsvervangend===plaatsvervangend;
om===om;
elfde===elfde;
op===op;
meerder===meerder;meerdere;
dynamisch===dynamisch;dynamische;
Servisch===Servisch;Servische;Servischer;Servischt;
gestoord===gestoord;
oraal===oraal;
voortijdig===voortijdig;
ijl===ijl;
aan===aan;
minuscuul===minuscuul;
analoog===analoog;analoge;analoogs;
onbeweeglijk===onbeweeglijk;onbeweeglijke;
waarachtig===waarachtig;waarachtiger;waarachtigst;
duister===duister;
populair===populair;populairder;populaire;populairst;
borstelig===borstelig;borsteliger;borsteligst;
betaalbaar===betaalbaar;betaalbare;
fysisch===fysisch;fysische;
benigne===benigne;
meelijwekkend===meelijwekkend;
prachtig===prachtig;prachtiger;prachtigst;
nieuwsgierig===nieuwsgierig;nieuwsgieriger;nieuwsgierigst;
Semitisch===Semitisch;Semitische;
gasvormig===gasvormig;gasvormige;
genant===genant;genante;
ziek===ziek;zieke;
artistiek===artistiek;artistieke;artistieker;artistiekst;
onbekwaam===onbekwaam;
sereen===sereen;sereens;sereenst;serener;
partieel===partieel;partieels;partieelst;
na===na;
specifiek===specifiek;specifieke;
walgelijk===walgelijk;walgelijke;walgelijker;walgelijks;walgelijkst;
gaaf===gaaf;
ongehoord===ongehoord;
beminnelijk===beminnelijk;beminnelijker;beminnelijkst;
gaar===gaar;gaars;
vervangbaar===vervangbaar;
tuberculeus===tuberculeus;
berooid===berooid;
leuk===leuk;leuke;leuks;
achterhaald===achterhaald;achterhaalde;achterhaalder;achterhaalds;achterhaaldst;
Dalmatisch===Dalmatisch;Dalmatischer;Dalmatischt;
Estisch===Estisch;Estische;Estischer;Estischt;
ingewikkeld===ingewikkeld;
wreed===wreed;wreedst;
eenzijdig===eenzijdig;eenzijdige;eenzijdiger;eenzijdigs;eenzijdigst;
cynisch===cynisch;cynische;cynischer;
stout===stout;stoutst;
langwijlig===langwijlig;
Deens===Deens;Deense;
bevorderlijk===bevorderlijk;
getikt===getikt;getikte;getikter;getikts;getiktst;
Romaans===Romaans;
homotopisch===homotopisch;
blut===blut;
cognitief===cognitief;
financieel===financieel;financiële;
orbitaal===orbitaal;
lijmerig===lijmerig;lijmerige;lijmeriger;lijmerigst;
afgelopen===afgelopen;
omvangrijk===omvangrijk;
overjaars===overjaars;
afkeurenswaardig===afkeurenswaardig;afkeurenswaardiger;afkeurenswaardigst;
toenmalig===toenmalig;toenmalige;
achenebbisj===achenebbisj;
schwul===schwul;
verleidelijk===verleidelijk;verleidelijker;verleidelijkst;
welwillend===welwillend;
duivelachtig===duivelachtig;duivelachtiger;duivelachtigst;
farmacologisch===farmacologisch;farmacologische;
in===in;
meewarig===meewarig;meewariger;
violet===violet;
damastachtig===damastachtig;
geroutineerd===geroutineerd;geroutineerder;geroutineerdst;
synthetisch===synthetisch;synthetische;
charismatisch===charismatisch;
veelgebruikt===veelgebruikt;veelgebruikte;
ontaard===ontaard;ontaarde;ontaards;
contant===contant;
onvruchtbaar===onvruchtbaar;
zedig===zedig;
emfatisch===emfatisch;emfatischer;
kleingeestig===kleingeestig;kleingeestiger;kleingeestigst;
radiaal===radiaal;
rusteloos===rusteloos;rusteloost;rusteloze;rustelozer;
oneven===oneven;
hol===hol;
autochtoon===autochtoon;autochtone;
copieus===copieus;
fruitachtig===fruitachtig;
radicaal===radicaal;
melig===melig;
soepel===soepel;soepeler;soepelst;
bagger===bagger;
chaotisch===chaotisch;
actueel===actueel;actuele;
moederlijk===moederlijk;moederlijke;
Joods===Joods;Joodse;
overdadig===overdadig;overdadiger;overdadigst;
hard===hard;harde;
onbeduidend===onbeduidend;onbeduidende;
blasfemisch===blasfemisch;
ingetogen===ingetogen;
vergeetachtig===vergeetachtig;vergeetachtiger;vergeetachtigst;
hartig===hartig;hartige;hartiger;hartigs;hartigst;
welgesteld===welgesteld;welgestelde;
exclusief===exclusief;exclusiefst;exclusiever;
spannend===spannend;spannende;
bewoond===bewoond;
monofyletisch===monofyletisch;
klaar===klaar;
mentaal===mentaal;
brutaal===brutaal;brutaals;brutaalst;brutale;
vertaalbaar===vertaalbaar;
IJslands===IJslands;IJslandse;
convecterend===convecterend;
burgerlijk===burgerlijk;
half===half;
onbeschaafd===onbeschaafd;
onverenigbaar===onverenigbaar;
luidkeels===luidkeels;
materieel===materieel;
zedelijk===zedelijk;
kortstondig===kortstondig;kortstondiger;kortstondigst;
argeloos===argeloos;argeloost;argeloze;
curieus===curieus;curieust;curieuze;
capricieus===capricieus;capricieust;capricieuzer;
liefdadig===liefdadig;
porrie===porrie;
verwilderd===verwilderd;
onbewogen===onbewogen;
onzeker===onzeker;onzekerder;onzekere;onzekerst;
virtueel===virtueel;
dagelijks===dagelijks;
zindelijk===zindelijk;
metriek===metriek;metrieke;metrieks;
suïcidaal===suïcidaal;suïcidale;
kinderloos===kinderloos;kinderloze;
continu===continu;continue;
traag===traag;
Australisch===Australisch;Australische;Australischer;Australischt;
levendig===levendig;
zenuwslopend===zenuwslopend;zenuwslopende;zenuwslopender;zenuwslopends;zenuwslopendst;
triomfantelijk===triomfantelijk;triomfantelijker;triomfantelijkst;
hoorbaar===hoorbaar;hoorbaarder;hoorbaars;hoorbaarst;hoorbare;
voorbijgekabbeld===voorbijgekabbeld;
woest===woest;woeste;
zoveelste===zoveelste;
overeenkomstig===overeenkomstig;overeenkomstige;
problematiek===problematiek;problematieker;problematiekst;
abominabel===abominabel;
meerlagig===meerlagig;
Siciliaans===Siciliaans;
benig===benig;
goedlachs===goedlachs;
noordelijk===noordelijk;noordelijke;noordelijker;noordelijks;noordelijkst;
fout===fout;
eiken===eiken;
snoezig===snoezig;
tolerant===tolerant;tolerante;toleranter;tolerants;tolerantst;
nieuwgekozen===nieuwgekozen;
onbetwist===onbetwist;onbetwister;
vrijgezel===vrijgezel;
sappig===sappig;
paarsig===paarsig;paarsiger;paarsigst;
inverteerbaar===inverteerbaar;
demagogisch===demagogisch;
vluchtig===vluchtig;
kaarsrecht===kaarsrecht;
bevriend===bevriend;
pornografisch===pornografisch;
ellendig===ellendig;ellendiger;ellendigst;
schoon===schoon;schoonst;
loodvrij===loodvrij;
consequent===consequent;
gierig===gierig;gieriger;gierigst;
Aziatisch===Aziatisch;
schamel===schamel;schameler;schamelst;
rechtdoorzee===rechtdoorzee;
onheilig===onheilig;
versleten===versleten;versletener;versletenst;
open===open;
sporadisch===sporadisch;
geijkt===geijkt;
gedetineerd===gedetineerd;gedetineerde;
onbelastbaar===onbelastbaar;
afgeplat===afgeplat;afgeplatte;
arm===arm;arme;
kersvers===kersvers;
gelijktijdig===gelijktijdig;gelijktijdige;
nulde===nulde;
fors===fors;forse;forst;
begaanbaar===begaanbaar;
Gallisch===Gallisch;
lichtblauw===lichtblauw;
knettergek===knettergek;
Macedonisch===Macedonisch;Macedonische;
organisch===organisch;
kansloos===kansloos;kansloost;kansloze;
uitbundig===uitbundig;
griepachtig===griepachtig;
besmettelijk===besmettelijk;
proportioneel===proportioneel;
keurig===keurig;
terroristisch===terroristisch;
Canadees===Canadees;Canadese;
blauwig===blauwig;blauwiger;blauwigst;
belligerent===belligerent;
ongelooflijk===ongelooflijk;ongelofelijk;ongelooflijke;ongelooflijker;ongelooflijks;ongelooflijkst;
smadelijk===smadelijk;smadelijker;smadelijkst;
magenta===magenta;
nachtblind===nachtblind;
doelloos===doelloos;
ontoereikend===ontoereikend;
Engels===Engels;
geschift===geschift;geschifte;geschifter;geschifts;geschiftst;
ontrouw===ontrouw;
etymologisch===etymologisch;etymologische;etymologischer;etymologischt;
belanghebbend===belanghebbend;belanghebbende;
eenvoudig===eenvoudig;eenvoudige;eenvoudiger;
Bulgaars===Bulgaars;Bulgaarse;
belastbaar===belastbaar;
behoeftig===behoeftig;behoeftige;behoeftiger;behoeftigs;behoeftigst;
scherper===scherper;scherpere;scherpers;
stellig===stellig;
bloederig===bloederig;
onovertroffen===onovertroffen;
toegevoegd===toegevoegd;toegevoegde;
geschikt===geschikt;geschikte;geschikter;geschikts;geschiktst;
middenst===middenst;middenste;
knap===knap;
deugdelijk===deugdelijk;deugdelijker;deugdelijkst;
buitengewoon===buitengewoon;buitengewone;buitengewoner;buitengewoonst;
proper===proper;
Portugees===Portugees;Portugese;
onbeteugeld===onbeteugeld;
grillig===grillig;grilliger;grilligst;
nodeloos===nodeloos;nodeloost;nodeloze;
chromosomaal===chromosomaal;
puur===puur;
degelijk===degelijk;
somber===somber;sombere;somberst;
verschillend===verschillend;verschillende;
slijmerig===slijmerig;
goedkoop===goedkoop;goedkoopst;goedkope;
afgrijselijk===afgrijselijk;afgrijselijke;
aangeschoten===aangeschoten;
pluis===pluis;
schadelijk===schadelijk;schadelijke;
overgankelijk===overgankelijk;
hindoeïstisch===hindoeïstisch;hindoeïstische;
hardnekkig===hardnekkig;hardnekkige;hardnekkiger;hardnekkigs;hardnekkigst;
agogiek===agogiek;
Trojaans===Trojaans;
reumatisch===reumatisch;
gezond===gezond;gezonde;gezondst;
vogelachtig===vogelachtig;
liederlijk===liederlijk;liederlijke;
onregelmatig===onregelmatig;onregelmatige;
vermeend===vermeend;vermeende;
wraakzuchtig===wraakzuchtig;
halfhartig===halfhartig;
Europees===Europees;Europese;Europeser;
bewonderenswaardig===bewonderenswaardig;bewonderenswaardiger;bewonderenswaardigst;
precair===precair;
zeldzaam===zeldzaam;zeldzaams;zeldzaamst;zeldzame;
Zuid-Soedanees===Zuid-Soedanees;
onpartijdig===onpartijdig;
jichtig===jichtig;
morbide===morbide;
ongewerveld===ongewerveld;
fossiel===fossiel;fossiele;
wekelijk===wekelijk;wekelijker;wekelijkst;
losbandig===losbandig;
magisch===magisch;magische;
leek===leek;
leed===leed;
liever===liever;lievere;
leeg===leeg;
sociaaldemocratisch===sociaaldemocratisch;sociaaldemocratische;
gematigd===gematigd;gematigde;gematigder;gematigdst;
utopisch===utopisch;
benedenwaarts===benedenwaarts;
koket===koket;koketst;kokette;
economisch===economisch;economische;economischer;economischt;
onwaarschijnlijk===onwaarschijnlijk;
Perzisch===Perzisch;
nonchalant===nonchalant;
onschuldig===onschuldig;
fatsoenlijk===fatsoenlijk;
nieuw===nieuw;nieuwe;nieuwer;nieuws;nieuwst;
psychedelisch===psychedelisch;
totaal===totaal;totaals;
verplicht===verplicht;verplichte;
deplorabel===deplorabel;
Israëlisch===Israëlisch;Israëlische;
afhankelijk===afhankelijk;afhankelijke;afhankelijker;afhankelijkst;
schunnig===schunnig;schunniger;schunnigst;
brisant===brisant;brisante;brisanter;brisants;brisantst;
Neerlands===Neerlands;
Rooms===Rooms;
gruwzaam===gruwzaam;
mondeling===mondeling;mondelinge;
speciaal===speciaal;speciaalst;speciale;
vormloos===vormloos;
afwisselend===afwisselend;
onschadelijk===onschadelijk;
wenselijk===wenselijk;wenselijke;wenselijker;wenselijks;wenselijkst;
kort===kort;korte;
fel===fel;
leep===leep;
rauw===rauw;rauwe;rauws;
ogenschijnlijk===ogenschijnlijk;
gammel===gammel;
onhoudbaar===onhoudbaar;
zwaarwegend===zwaarwegend;
onbereikbaar===onbereikbaar;onbereikbaarder;onbereikbaarst;
tegenovergesteld===tegenovergesteld;
nep===nep;neps;
handgemaakt===handgemaakt;
humeurig===humeurig;
net===net;
inefficiënt===inefficiënt;inefficiënter;inefficiëntst;
minderjarig===minderjarig;minderjarige;
hoopvol===hoopvol;hoopvoller;hoopvolst;
plezierig===plezierig;plezieriger;plezierigst;
lichtrood===lichtrood;
vierhoekig===vierhoekig;
baptistisch===baptistisch;baptistische;
ondeugend===ondeugend;ondeugende;
koud===koud;koude;
onbewoond===onbewoond;
geregeld===geregeld;geregelde;
uitzonderlijk===uitzonderlijk;uitzonderlijke;uitzonderlijker;uitzonderlijkst;
communistisch===communistisch;
Sorbisch===Sorbisch;
onnodig===onnodig;onnodige;onnodiger;onnodigs;onnodigst;
machteloos===machteloos;
microscopisch===microscopisch;microscopische;microscopischer;microscopischt;
houterig===houterig;houteriger;houterigst;
eigenzinnig===eigenzinnig;eigenzinnige;
afgezonderd===afgezonderd;afgezonderde;
compact===compact;compacte;
woonachtig===woonachtig;
frivool===frivool;frivoolst;
afschrikwekkend===afschrikwekkend;afschrikwekkende;
sjagerijn===sjagerijn;
Fries===Fries;Friese;
doelbewust===doelbewust;
komisch===komisch;
dement===dement;demente;dementer;dements;dementst;
lijdend===lijdend;
alfabetisch===alfabetisch;alfabetische;
homoseksueel===homoseksueel;
Oost-Vlaams===Oost-Vlaams;Oost-Vlaamser;Oost-Vlaamst;
elektromagnetisch===elektromagnetisch;elektromagnetische;
melancholiek===melancholiek;
keigoed===keigoed;
doortastend===doortastend;
respectvol===respectvol;respectvolle;respectvoller;respectvols;respectvolst;
rooi===rooi;
voortvarend===voortvarend;
rood===rood;
epidemiologisch===epidemiologisch;epidemiologische;
frauduleus===frauduleus;
tweetallig===tweetallig;tweetallige;
beschaafd===beschaafd;beschaafde;
journalistiek===journalistiek;journalistieke;
onrechtstreeks===onrechtstreeks;
tastbaar===tastbaar;
eidetisch===eidetisch;
lager===lager;lagere;
autonoom===autonoom;autonome;
herlaadbaar===herlaadbaar;
rijkbedeeld===rijkbedeeld;
greeploos===greeploos;
bijvoeglijk===bijvoeglijk;bijvoeglijke;
rond===rond;
naamloos===naamloos;
tweeloops===tweeloops;
demissionair===demissionair;
fraai===fraai;fraaie;
intijds===intijds;
zelfzeker===zelfzeker;
dienstplichtig===dienstplichtig;dienstplichtige;
coöperatief===coöperatief;
uiterst===uiterst;uiterste;
onmisbaar===onmisbaar;onmisbaarst;
nat===nat;
Nederduits===Nederduits;
prominent===prominent;prominente;
voorbereidend===voorbereidend;
besluiteloos===besluiteloos;besluitelozer;
zorgvuldig===zorgvuldig;zorgvuldige;zorgvuldiger;zorgvuldigs;zorgvuldigst;
oliehoudend===oliehoudend;
duffels===duffels;duffelse;
tolerabel===tolerabel;tolerabele;tolerabeler;tolerabels;tolerabelst;
puntgaaf===puntgaaf;
vroegtijdig===vroegtijdig;vroegtijdiger;vroegtijdigst;
kleinzerig===kleinzerig;
luxueus===luxueus;luxueust;luxueuze;
gerelateerd===gerelateerd;gerelateerde;
opmerkelijk===opmerkelijk;opmerkelijke;
rank===rank;
vaderloos===vaderloos;
gedwongen===gedwongen;
gevaarlijk===gevaarlijk;gevaarlijker;gevaarlijkst;
doorwaadbaar===doorwaadbaar;doorwaadbaarder;doorwaadbaarst;
Afghaans===Afghaans;Afghaanse;
sferisch===sferisch;sferischer;sferischt;
honds===honds;
bijbehorend===bijbehorend;bijbehorende;
nabijgelegen===nabijgelegen;
volgzaam===volgzaam;volgzaamst;
hemelwijd===hemelwijd;
Roemeens===Roemeens;Roemeense;
onderliggend===onderliggend;onderliggende;
sfeervol===sfeervol;sfeervoller;sfeervolst;
falsifieerbaar===falsifieerbaar;falsifieerbaarder;falsifieerbaars;falsifieerbaarst;falsifieerbare;
buiig===buiig;buiiger;buiigst;
evenredig===evenredig;evenredige;evenrediger;evenredigs;evenredigst;
schijnheilig===schijnheilig;schijnheilige;schijnheiliger;schijnheiligs;schijnheiligst;
zesde===zesde;
rechtshandig===rechtshandig;
Afrikaans===Afrikaans;
doodeng===doodeng;
zonderling===zonderling;
kristallen===kristallen;
voortreffelijk===voortreffelijk;
zomers===zomers;
seniel===seniel;
ongeldig===ongeldig;
attractief===attractief;attractiefs;attractiefst;attractieve;attractiever;
Hongaars===Hongaars;Hongaarse;
stevig===stevig;stevige;steviger;stevigst;
neukbaar===neukbaar;
feitelijk===feitelijk;feitelijke;
blootvoets===blootvoets;
oneerbiedig===oneerbiedig;
kruidachtig===kruidachtig;
triest===triest;
vervelend===vervelend;vervelende;
bijtgraag===bijtgraag;
nors===nors;
bekakt===bekakt;
stijlvol===stijlvol;
sympathiek===sympathiek;sympathieke;sympathieker;sympathieks;sympathiekst;
infrarood===infrarood;
asferisch===asferisch;asferische;
genoemd===genoemd;genoemde;
antropologisch===antropologisch;
nachtelijk===nachtelijk;
muurvast===muurvast;
ongedaan===ongedaan;ongedane;
indicatief===indicatief;
bijkomend===bijkomend;
minzaam===minzaam;minzaamst;
getekend===getekend;
weerloos===weerloos;
ononderbroken===ononderbroken;
adembenemend===adembenemend;
welingelicht===welingelicht;
bebloed===bebloed;bebloeder;
vergeven===vergeven;
onderscheiden===onderscheiden;
zwaargewond===zwaargewond;zwaargewonde;
genadeloos===genadeloos;genadeloze;
realiseerbaar===realiseerbaar;
buitenaards===buitenaards;
eerbiedig===eerbiedig;
volslagen===volslagen;volslagener;volslagenst;
officieus===officieus;
onpasselijk===onpasselijk;
polynomiaal===polynomiaal;
evenwoordig===evenwoordig;
idioot===idioot;
hongerig===hongerig;
jarenlang===jarenlang;
dertiende===dertiende;
onfeilbaar===onfeilbaar;
eenzaadlobbig===eenzaadlobbig;eenzaadlobbige;
beurs===beurs;
voorlaatst===voorlaatst;voorlaatste;
rotsvast===rotsvast;
fabrieksmatig===fabrieksmatig;fabrieksmatige;fabrieksmatiger;fabrieksmatigs;fabrieksmatigst;
betoverend===betoverend;
geruisloos===geruisloos;
leefbaar===leefbaar;leefbaarder;leefbaars;leefbaarst;leefbare;
geïnteresseerd===geïnteresseerd;geïnteresseerde;
bovengemiddeld===bovengemiddeld;bovengemiddelde;
Middelengels===Middelengels;
nederlandstalige===nederlandstalige;
knots===knots;
overaftelbaar===overaftelbaar;
onmiskenbaar===onmiskenbaar;onmiskenbare;
oranje===oranje;
Japans===Japans;
conisch===conisch;conische;conischer;conischt;
hilarisch===hilarisch;hilarischer;
gelukkig===gelukkig;gelukkige;gelukkiger;gelukkigst;
noordoostelijk===noordoostelijk;noordoostelijke;noordoostelijker;noordoostelijkst;
fragiel===fragiel;fragieler;fragielst;
Kazachs===Kazachs;
climacterisch===climacterisch;
onwelvoeglijk===onwelvoeglijk;
strikt===strikt;
toereikend===toereikend;
lafhartig===lafhartig;lafhartige;lafhartiger;lafhartigs;lafhartigst;
transgender===transgender;
afwijkend===afwijkend;afwijkende;
loslippig===loslippig;
ongecontroleerd===ongecontroleerd;
Indiaas===Indiaas;
nominatief===nominatief;
Iraans===Iraans;Iraanse;Iraanser;Iraanst;
netjes===netjes;
voltijds===voltijds;
smaakvol===smaakvol;
Nederduytsche===Nederduytsche;
gezellig===gezellig;
vraatzuchtig===vraatzuchtig;vraatzuchtige;vraatzuchtiger;vraatzuchtigs;vraatzuchtigst;
beroemd===beroemd;beroemde;beroemder;beroemdst;
bewusteloos===bewusteloos;bewusteloze;
sektarisch===sektarisch;
roze===roze;
soporatief===soporatief;soporatieve;
optimistisch===optimistisch;optimistische;
smartelijk===smartelijk;
beweeglijk===beweeglijk;
onoverwinnelijk===onoverwinnelijk;
nul===nul;
pittig===pittig;pittiger;pittigst;
filosofisch===filosofisch;filosofische;
leerstellig===leerstellig;
eeneiig===eeneiig;eeneiige;
bedeesd===bedeesd;
chronisch===chronisch;chronische;
synoniem===synoniem;synonieme;
wezenlijk===wezenlijk;
angstwekkend===angstwekkend;
gepeperd===gepeperd;
stabiel===stabiel;
intrinsiek===intrinsiek;
konings===konings;
lieflijk===lieflijk;lieflijke;lieflijker;lieflijks;lieflijkst;
blij===blij;
statisch===statisch;statischer;statischt;
ignorant===ignorant;
langdradig===langdradig;langdradiger;langdradigst;
aangedaan===aangedaan;
aanzienlijk===aanzienlijk;aanzienlijke;
autoritair===autoritair;autoritairder;autoritairst;
surrealistisch===surrealistisch;surrealistische;
volbloed===volbloed;
Iraaks===Iraaks;Iraakse;
bladverliezend===bladverliezend;
uitstaand===uitstaand;
Turks===Turks;
goudblond===goudblond;
gesmoord===gesmoord;
vertegenwoordigen===vertegenwoordigen;vertegenwoordigend;
erg===erg;erge;ergs;
verweven===verweven;
diamagnetisch===diamagnetisch;
wettig===wettig;
tweevoets===tweevoets;
kortdurend===kortdurend;
Slavisch===Slavisch;Slavische;
stuwend===stuwend;
pauselijk===pauselijk;pauselijke;
Waals===Waals;
omvattend===omvattend;
slank===slank;slanke;slanker;slanks;slankst;
heilzaam===heilzaam;heilzaamst;
onzuiver===onzuiver;
patricisch===patricisch;
bezorgen===bezorgen;bezorgd;
levenloos===levenloos;
taalkundig===taalkundig;taalkundige;
buitenlands===buitenlands;
hopeloos===hopeloos;
congruent===congruent;
doelmatig===doelmatig;doelmatiger;doelmatigst;
lichtvoetig===lichtvoetig;lichtvoetiger;lichtvoetigst;
courant===courant;couranter;courantst;
onverzadigbaar===onverzadigbaar;onverzadigbaarder;onverzadigbaars;onverzadigbaarst;onverzadigbare;
beeldschoon===beeldschoon;beeldschoner;beeldschoonst;
vers===vers;verse;verst;
evasief===evasief;evasiefst;
vermaard===vermaard;vermaarde;vermaarder;vermaards;vermaardst;
uitwendig===uitwendig;
visueel===visueel;visueels;visueelst;visuele;visueler;
eender===eender;
wederzijds===wederzijds;
eigentijds===eigentijds;
sletterig===sletterig;
fabelachtig===fabelachtig;fabelachtige;fabelachtiger;fabelachtigs;fabelachtigst;
bevallig===bevallig;
afzichtelijk===afzichtelijk;
mild===mild;milde;
verlengd===verlengd;verlengde;
legendarisch===legendarisch;
Helleens===Helleens;
bewolkt===bewolkt;bewolkter;
nietig===nietig;nietige;
vuil===vuil;vuile;
hemels===hemels;hemelse;
kwaadschiks===kwaadschiks;
onverbogen===onverbogen;onverbogene;
zakelijk===zakelijk;zakelijker;zakelijkst;
mank===mank;
privé===privé;
schijterig===schijterig;schijterige;schijteriger;schijterigs;schijterigst;
onzijdig===onzijdig;onzijdige;onzijdiger;onzijdigs;onzijdigst;
grotesk===grotesk;
gallisch===gallisch;
rimpelloos===rimpelloos;
eng===eng;
duidelijk===duidelijk;
levensloos===levensloos;
theoretisch===theoretisch;
huiselijk===huiselijk;
mals===mals;malst;
schrikwekkend===schrikwekkend;
tendentieus===tendentieus;tendentieust;tendentieuze;tendentieuzer;
zuidwaarts===zuidwaarts;
heetgebakerd===heetgebakerd;
verouderd===verouderd;verouderde;verouderder;verouderds;verouderdst;
vertrouwd===vertrouwd;
actief===actief;actieve;
houtig===houtig;
armoedig===armoedig;armoediger;armoedigst;
Limburgs===Limburgs;
hydrodynamisch===hydrodynamisch;hydrodynamische;
guur===guur;
gesloten===gesloten;
pederastisch===pederastisch;
fanatiek===fanatiek;fanatieker;fanatiekst;
hooghartig===hooghartig;
diplomatiek===diplomatiek;
Galicisch===Galicisch;
officieel===officieel;officieelst;officiëler;
hecht===hecht;hechte;hechter;hechts;hechtst;
pijnloos===pijnloos;
kerkelijk===kerkelijk;
donkergeel===donkergeel;
moerassig===moerassig;
paradoxaal===paradoxaal;
koel===koel;koele;
expressionistisch===expressionistisch;
pycnisch===pycnisch;
fictief===fictief;
constitutioneel===constitutioneel;
manueel===manueel;manuele;
realistisch===realistisch;realistische;
hittebestendig===hittebestendig;hittebestendige;
vele===vele;
beschoren===beschoren;
buitenst===buitenst;buitenste;
respectievelijk===respectievelijk;
eigenhandig===eigenhandig;
onvoorspelbaar===onvoorspelbaar;
maagdelijk===maagdelijk;
muzikaal===muzikaal;muzikaalst;muzikale;
kordaat===kordaat;
Caraïbisch===Caraïbisch;
aanneembaar===aanneembaar;
naadloos===naadloos;
gewoon===gewoon;gewoons;gewoonst;
obsceen===obsceen;obsceenst;obscener;
oprecht===oprecht;oprechte;oprechter;oprechtst;
beperkt===beperkt;beperkte;beperkter;
geologisch===geologisch;geologische;
verrukkelijk===verrukkelijk;verrukkelijker;verrukkelijkst;
gunstig===gunstig;gunstige;gunstiger;gunstigst;
wankel===wankel;
schril===schril;
Frankisch===Frankisch;
vakkundig===vakkundig;vakkundiger;vakkundigst;
lokaal===lokaal;
Braziliaans===Braziliaans;Braziliaanse;Braziliaanser;Braziliaanst;
historisch===historisch;historische;
waterig===waterig;
hoekig===hoekig;hoekiger;hoekigst;
nostalgisch===nostalgisch;nostalgische;
parafyletisch===parafyletisch;
ingesneeuwd===ingesneeuwd;
compres===compres;
mesjogge===mesjogge;
krokant===krokant;krokante;krokanter;krokantst;
harmonisch===harmonisch;harmonische;harmonischer;harmonischt;
juist===juist;juiste;
flexibel===flexibel;flexibeler;flexibelst;
pijnlijk===pijnlijk;pijnlijke;pijnlijker;pijnlijkst;
godvruchtig===godvruchtig;godvruchtiger;godvruchtigst;
algeheel===algeheel;algehele;
Groenlands===Groenlands;
excentrisch===excentrisch;excentrische;
parasitair===parasitair;parasitaire;
stijf===stijf;
haastig===haastig;haastiger;haastigst;
apart===apart;
comateus===comateus;
doodziek===doodziek;
pleite===pleite;
uniek===uniek;unieke;
veeg===veeg;
eetbaar===eetbaar;
diepzinnig===diepzinnig;diepzinniger;diepzinnigst;
onkwetsbaar===onkwetsbaar;onkwetsbaarder;onkwetsbaars;onkwetsbaarst;onkwetsbare;
praktisch===praktisch;praktische;praktischer;
ongefundeerd===ongefundeerd;
Numidisch===Numidisch;
smakelijk===smakelijk;smakelijker;smakelijkst;
foutief===foutief;foutiefs;foutiefst;foutieve;
amfoteer===amfoteer;
ontbeerlijk===ontbeerlijk;
zachtaardig===zachtaardig;zachtaardiger;zachtaardigst;
explosief===explosief;
sociaal===sociaal;sociaalst;
vooraanstaand===vooraanstaand;vooraanstaande;
wendbaar===wendbaar;wendbaarder;wendbaarst;
atmosferisch===atmosferisch;atmosferische;
wee===wee;
overzees===overzees;overzeese;
duizelig===duizelig;
onvertaalbaar===onvertaalbaar;
beschilderd===beschilderd;
bloedmooi===bloedmooi;bloedmooier;bloedmooist;
machinaal===machinaal;machinaals;machinale;
heiig===heiig;heiige;heiiger;heiigs;heiigst;
grijsachtig===grijsachtig;
fris===fris;frist;
breed===breed;
genetisch===genetisch;genetische;
Zweeds===Zweeds;Zweedse;
hoofdzakelijk===hoofdzakelijk;
Iers===Iers;
oerhollands===oerhollands;
driehoekig===driehoekig;
andersvalide===andersvalide;
verrassend===verrassend;
volgend===volgend;volgende;
driekwart===driekwart;
satiriek===satiriek;satirieke;satirieker;satirieks;satiriekst;
verleden===verleden;
werkschuw===werkschuw;
passief===passief;
koosjer===koosjer;
regenachtig===regenachtig;regenachtiger;regenachtigst;
ongedeeld===ongedeeld;ongedeelde;
invloedrijk===invloedrijk;invloedrijke;invloedrijker;invloedrijkst;
wrang===wrang;
geworteld===geworteld;gewortelde;
achterdochtig===achterdochtig;
enkelbaans===enkelbaans;
gek===gek;
wiskundig===wiskundig;wiskundige;
pantheïstisch===pantheïstisch;
metaforisch===metaforisch;metaforische;
zwaarmoedig===zwaarmoedig;
geweldloos===geweldloos;geweldloze;
buikvinnig===buikvinnig;
maritiem===maritiem;
onbegaanbaar===onbegaanbaar;
oosters===oosters;
wis===wis;
wit===wit;
bijster===bijster;
middelmatig===middelmatig;
pisnijdig===pisnijdig;
heterofiel===heterofiel;
mogolisch===mogolisch;
zinnig===zinnig;zinnige;zinniger;zinnigst;
zeventiende===zeventiende;
cardiologisch===cardiologisch;
beeldig===beeldig;
opperbest===opperbest;
auditief===auditief;
schitterend===schitterend;
plechtig===plechtig;plechtiger;plechtigst;
onvoldoende===onvoldoende;
zenuwachtig===zenuwachtig;
overspannen===overspannen;
straatarm===straatarm;straatarmer;straatarmst;
alleraardigst===alleraardigst;
getalenteerd===getalenteerd;getalenteerde;
adellijk===adellijk;adellijke;
rommelig===rommelig;rommelige;rommeliger;rommeligs;rommeligst;
tweepotig===tweepotig;
feeëriek===feeëriek;feeërieker;feeëriekst;
overerfbaar===overerfbaar;
vernuftig===vernuftig;
nodig===nodig;
detecteerbaar===detecteerbaar;detecteerbare;
bangelijk===bangelijk;bangelijke;bangelijker;bangelijks;bangelijkst;
ferromagnetisch===ferromagnetisch;
mathematisch===mathematisch;mathematische;
polygaam===polygaam;polygame;
lelijk===lelijk;lelijkst;
gemeenschappelijk===gemeenschappelijk;gemeenschappelijke;
wijsgerig===wijsgerig;
bekwaam===bekwaam;bekwaamst;
geestdodend===geestdodend;
opgelaten===opgelaten;
beschikbaar===beschikbaar;beschikbare;
rins===rins;
waardeloos===waardeloos;waardeloost;waardeloze;waardelozer;
jarig===jarig;jarige;
geelachtig===geelachtig;geelachtige;
begeerd===begeerd;
onsmakelijk===onsmakelijk;onsmakelijker;onsmakelijkst;
manifest===manifest;
prophylactisch===prophylactisch;
onderbewust===onderbewust;onderbewuste;
denkbaar===denkbaar;denkbare;
geestig===geestig;geestige;geestiger;geestigs;geestigst;
buitenechtelijk===buitenechtelijk;
onverholen===onverholen;
traditioneel===traditioneel;traditioneelst;traditionele;traditioneler;
fluweelzacht===fluweelzacht;
trouw===trouw;trouwe;trouwer;trouws;trouwst;
razend===razend;
perinataal===perinataal;
ellenlang===ellenlang;
luxe===luxe;
zinvol===zinvol;
noemenswaardig===noemenswaardig;noemenswaardiger;noemenswaardigst;
menselijk===menselijk;menselijke;
lollig===lollig;
Anatolisch===Anatolisch;
futloos===futloos;
grondig===grondig;grondige;grondiger;grondigs;grondigst;
sneeuwwit===sneeuwwit;
teleurgesteld===teleurgesteld;
zwanger===zwanger;
onwerkelijk===onwerkelijk;
kosmologisch===kosmologisch;
onbezield===onbezield;onbezielder;onbezieldst;
bleek===bleek;bleekst;
joods===joods;joodse;
gebonden===gebonden;
lederen===lederen;
allemachtig===allemachtig;
drievoudig===drievoudig;
eenarmig===eenarmig;
verbaal===verbaal;verbale;
nachtmerrieachtig===nachtmerrieachtig;nachtmerrie-achtig;
flink===flink;flinke;flinker;flinks;flinkst;
centrumrechts===centrumrechts;centrumrechtse;
pikzwart===pikzwart;
vroed===vroed;
vroeg===vroeg;vroege;vroeger;vroegst;
eenzaam===eenzaam;eenzaams;eenzaamst;eenzame;
miezerig===miezerig;miezerige;miezeriger;miezerigs;miezerigst;
griezelig===griezelig;griezeliger;griezeligst;
veertiende===veertiende;
Hebreeuws===Hebreeuws;Hebreeuwse;Hebreeuwser;Hebreeuwst;
zeker===zeker;zekere;zekers;zekerst;
zelfingenomen===zelfingenomen;
Oezbeeks===Oezbeeks;
recht===recht;rechte;rechtst;
onvoorbereid===onvoorbereid;
treurig===treurig;
overtollig===overtollig;overtollige;overtolliger;overtolligst;
vierkant===vierkant;
altijddurend===altijddurend;
sprakeloos===sprakeloos;sprakeloze;
Parijs===Parijs;Parijse;
ultiem===ultiem;ultieme;
homofiel===homofiel;
Kanaänitisch===Kanaänitisch;
daaruitvolgend===daaruitvolgend;
vuurvast===vuurvast;
lazarus===lazarus;
handig===handig;handige;
astronomisch===astronomisch;astronomische;
opgetogen===opgetogen;
intens===intens;intense;intenser;intenst;
eindig===eindig;eindige;
duur===duur;duurs;
monumentaal===monumentaal;monumentale;
hartvormig===hartvormig;hartvormige;
interpretabel===interpretabel;
eenlettergrepig===eenlettergrepig;
atavistisch===atavistisch;
dimensioneel===dimensioneel;
dicht===dicht;dichter;dichtst;
aftelbaar===aftelbaar;
deelbaar===deelbaar;
getogen===getogen;
creatief===creatief;creatiefst;creatieve;creatiever;
onomstreden===onomstreden;
verboden===verboden;
vergelijkbaar===vergelijkbaar;
antropomorfisch===antropomorfisch;antropomorfische;
Slowaaks===Slowaaks;Slowaakse;Slowaakser;Slowaakst;
innig===innig;
zuidoostelijk===zuidoostelijk;zuidoostelijke;zuidoostelijker;zuidoostelijkst;
lateraal===lateraal;laterale;
bovennatuurlijk===bovennatuurlijk;bovennatuurlijke;
aardig===aardig;aardige;
verachtelijk===verachtelijk;verachtelijker;verachtelijkst;
bolrond===bolrond;
minimalistisch===minimalistisch;minimalistische;
gelijk===gelijk;gelijke;
negenvoudig===negenvoudig;
hautain===hautain;
betreurenswaardig===betreurenswaardig;betreurenswaardiger;betreurenswaardigst;
geladen===geladen;geladener;geladens;geladenst;
veranderlijk===veranderlijk;veranderlijker;veranderlijkst;
gewis===gewis;
zijwaarts===zijwaarts;zijwaartse;
Tibetaans===Tibetaans;Tibetaanse;
benieuwd===benieuwd;
eenenveertigste===eenenveertigste;
stoffig===stoffig;
toegankelijk===toegankelijk;toegankelijke;toegankelijker;toegankelijkst;
lawaaierig===lawaaierig;lawaaieriger;lawaaierigst;
samengesteld===samengesteld;
flanellen===flanellen;fanellen;
onvoorzichtig===onvoorzichtig;onvoorzichtiger;onvoorzichtigst;
bezwaarlijk===bezwaarlijk;bezwaarlijke;bezwaarlijker;bezwaarlijks;bezwaarlijkst;
periodiek===periodiek;periodieke;
enthousiast===enthousiast;
oververhit===oververhit;
gewerveld===gewerveld;gewervelde;
Saksisch===Saksisch;
onrustig===onrustig;onrustiger;onrustigst;
bereid===bereid;
onderling===onderling;onderlinge;
dansbaar===dansbaar;
integraal===integraal;
bevreesd===bevreesd;bevreesde;
provinciaal===provinciaal;provinciale;
expansief===expansief;expansiefst;expansieve;expansiever;
natuurkundig===natuurkundig;natuurkundige;
indringend===indringend;
oud===oud;oude;
gegoed===gegoed;
licht===licht;lichter;lichtst;
marxistisch===marxistisch;marxistische;marxistischer;marxistischt;
rijp===rijp;
beraden===beraden;beradener;beradenst;
rijk===rijk;rijke;rijks;
verspillend===verspillend;
bruin===bruin;bruine;bruiner;bruins;bruinst;
parmantig===parmantig;
Marokkaans===Marokkaans;
droog===droog;
onvermijdelijk===onvermijdelijk;
tienjarig===tienjarig;
bondig===bondig;
orthonormaal===orthonormaal;
roerig===roerig;
hemelsblauw===hemelsblauw;
radioactief===radioactief;radioactieve;
ondergistend===ondergistend;
zogeheten===zogeheten;
ongeoorloofd===ongeoorloofd;
eentonig===eentonig;
fier===fier;
werkelijk===werkelijk;
ongeschikt===ongeschikt;
getrouw===getrouw;getrouwe;
achterlijk===achterlijk;
vroom===vroom;vroomst;
koloniaal===koloniaal;
bescheiden===bescheiden;bescheidener;bescheidens;bescheidenst;
equidistant===equidistant;
Praags===Praags;Praagse;
blauwgroen===blauwgroen;
onbeperkt===onbeperkt;
helder===helder;heldere;
gluiperig===gluiperig;
kleurrijk===kleurrijk;kleurrijke;kleurrijker;kleurrijkst;
deeltijds===deeltijds;
goedgeefs===goedgeefs;
simultaan===simultaan;
aantrekkelijk===aantrekkelijk;aantrekkelijke;aantrekkelijker;aantrekkelijks;aantrekkelijkst;
fiks===fiks;fikse;
luid===luid;
bezweet===bezweet;
sober===sober;soberst;
stapsgewijs===stapsgewijs;stepsgewijze;
Pools===Pools;Poolse;
talentvol===talentvol;
Maleisisch===Maleisisch;
Spaans===Spaans;Spaanse;
ongehuwd===ongehuwd;
bruut===bruut;bruuts;bruutst;
Marshallees===Marshallees;
geweldig===geweldig;
twintigste===twintigste;
vergaand===vergaand;vergaande;
drukkend===drukkend;drukkende;
glad===glad;
veelvuldig===veelvuldig;veelvuldige;
afgelegen===afgelegen;
oké===oké;
poenaal===poenaal;
heterogeen===heterogeen;heterogene;
lichtgeel===lichtgeel;
gespannen===gespannen;
nijver===nijver;nijverst;
fijn===fijn;
geldswaardig===geldswaardig;
tegenwoordig===tegenwoordig;
bewust===bewust;bewuste;
rechtstreeks===rechtstreeks;
enig===enig;enige;
Kabbalistisch===Kabbalistisch;
stipt===stipt;
scheikundig===scheikundig;scheikundige;
gehandicapt===gehandicapt;gehandicapte;
overduidelijk===overduidelijk;
Oudengels===Oudengels;Oudengelse;
wantrouwend===wantrouwend;
ondenkbaar===ondenkbaar;ondenkbare;
chemisch===chemisch;chemische;
uitzichtloos===uitzichtloos;uitzichtloze;
futuristisch===futuristisch;
appelblauwzeegroen===appelblauwzeegroen;
piekfijn===piekfijn;
gemiddeld===gemiddeld;gemiddelde;
sociolinguïstisch===sociolinguïstisch;
chagrijnig===chagrijnig;chagrijnige;chagrijniger;chagrijnigst;
geschat===geschat;geschatte;
neutraal===neutraal;
separatistisch===separatistisch;separatistische;
grauw===grauw;grauwe;
fluvioglaciaal===fluvioglaciaal;
Mongools===Mongools;
heuvelachtig===heuvelachtig;
onsterfelijk===onsterfelijk;
groenachtig===groenachtig;groenachtige;
handmatig===handmatig;handmatige;
ongeneeslijk===ongeneeslijk;
gevleugeld===gevleugeld;
droef===droef;
kortaf===kortaf;kortaffe;kortafst;
kletsnat===kletsnat;
jaloers===jaloers;
enkel===enkel;
standaard===standaard;
vacuüm===vacuüm;
demonstratief===demonstratief;demonstratiefst;demonstratieve;demonstratiever;
onkreukbaar===onkreukbaar;onkreukbaarder;onkreukbaars;onkreukbaarst;onkreukbare;
huidig===huidig;huidige;huidigs;
uitheems===uitheems;uitheemse;
beschaamd===beschaamd;
liefdevol===liefdevol;
Angelsaksisch===Angelsaksisch;Angelsaksische;
raak===raak;
decoratief===decoratief;
verdraaglijk===verdraaglijk;
Berbers===Berbers;
duivels===duivels;
recent===recent;recente;recenter;recentst;
volledig===volledig;volledige;vollediger;volledigst;
fit===fit;
laconiek===laconiek;
vol===vol;
binnenlands===binnenlands;
bouwvallig===bouwvallig;
perfect===perfect;perfecte;
achtvoudig===achtvoudig;
ransig===ransig;
axiologisch===axiologisch;
deugdzaam===deugdzaam;
bijgenaamd===bijgenaamd;
zestiende===zestiende;
zittend===zittend;zittende;
inwendig===inwendig;inwendige;
karakteristiek===karakteristiek;karakteristieke;karakteristieker;karakteristiekst;
raar===raar;raars;
naburig===naburig;naburige;
spiritueel===spiritueel;spiritueelst;spiritueler;
kronkelend===kronkelend;
ongevoelig===ongevoelig;ongevoeliger;ongevoeligst;
posthuum===posthuum;posthume;posthuums;
geprononceerd===geprononceerd;
minder===minder;
hermeneutisch===hermeneutisch;
toepasselijk===toepasselijk;toepasselijke;toepasselijker;toepasselijks;toepasselijkst;
voldaan===voldaan;voldane;
duurzaam===duurzaam;duurzaams;duurzaamst;duurzame;
ongewenst===ongewenst;
pedagogisch===pedagogisch;pedagogische;
onvriendelijk===onvriendelijk;onvriendelijke;onvriendelijker;onvriendelijkst;
koortsachtig===koortsachtig;
devoot===devoot;devootst;
gewild===gewild;gewilde;
Myceens===Myceens;Myceense;
ondoordringbaar===ondoordringbaar;
geografisch===geografisch;geografische;
cilindrisch===cilindrisch;
divers===divers;diverse;
mannelijk===mannelijk;
prefix===prefix;
matig===matig;
vruchteloos===vruchteloos;vruchteloost;vruchteloze;vruchtelozer;
blauw===blauw;blauwe;blauwer;blauws;blauwst;
ver===ver;
vet===vet;
Latijns===Latijns;
averechts===averechts;
islamitisch===islamitisch;islamitische;islamitischer;islamitischt;
vijflettergrepig===vijflettergrepig;
dubieus===dubieus;dubieust;dubieuze;
olympisch===olympisch;olympische;
droevig===droevig;droeviger;droevigst;
paraat===paraat;
halfnaakt===halfnaakt;
bars===bars;
universitair===universitair;universitaire;universitairs;
onhebbelijk===onhebbelijk;
Nederlandstalig===Nederlandstalig;Nederlandstalige;
diepgaand===diepgaand;
elegant===elegant;elegante;elegantst;
anderstalig===anderstalig;
catastrofaal===catastrofaal;catastrofale;
toeristisch===toeristisch;toeristische;
liefst===liefst;liefste;
medisch===medisch;medische;
sacraal===sacraal;
hogergeschoold===hogergeschoold;hogergeschoolde;
Ingrisch===Ingrisch;
onbemand===onbemand;
uiterlijk===uiterlijk;
blijvend===blijvend;blijvende;
hulpeloos===hulpeloos;
feministisch===feministisch;
tiranniek===tiranniek;tirannieker;tiranniekst;
hoog===hoog;
bang===bang;bange;
geinig===geinig;geiniger;geinigst;
Diets===Diets;
patriarchaal===patriarchaal;
kleverig===kleverig;kleverige;kleveriger;kleverigst;
maatschappelijk===maatschappelijk;maatschappelijke;
kleurloos===kleurloos;
vorig===vorig;
achthoekig===achthoekig;
dorstig===dorstig;dorstige;
gegrond===gegrond;
adequaat===adequaat;
prettig===prettig;prettiger;prettigst;
laf===laf;lafs;
vreselijk===vreselijk;
voorspelbaar===voorspelbaar;
Platduits===Platduits;
lam===lam;
partijdig===partijdig;
hoofdstedelijk===hoofdstedelijk;
stedelijk===stedelijk;stedelijke;
gulzig===gulzig;gulzige;gulziger;gulzigs;gulzigst;
behoorlijk===behoorlijk;behoorlijke;behoorlijker;behoorlijkst;
slordig===slordig;slordige;slordiger;slordigs;slordigst;
gewijd===gewijd;
ondeugdelijk===ondeugdelijk;
scherpzinnig===scherpzinnig;scherpzinniger;scherpzinnigst;
Nepalees===Nepalees;Nepalese;
pasklaar===pasklaar;
kits===kits;
royaal===royaal;royaalst;
neerwaarts===neerwaarts;
dolfijn===dolfijn;
olijfkleurig===olijfkleurig;
geheel===geheel;
lichtzinnig===lichtzinnig;lichtzinniger;lichtzinnigst;
onverstandig===onverstandig;onverstandiger;onverstandigst;
sarcastisch===sarcastisch;sarcastische;
ijskoud===ijskoud;ijskoude;
bazig===bazig;bazige;
gevat===gevat;gevatst;
kut===kut;
inhoudelijk===inhoudelijk;
wild===wild;wilde;
neerbuigend===neerbuigend;
schandelijk===schandelijk;schandelijker;schandelijkst;
gelovig===gelovig;gelovige;geloviger;gelovigs;gelovigst;
gerenommeerd===gerenommeerd;gerenommeerde;gerenommeerder;gerenommeerds;gerenommeerdst;
voorzichtig===voorzichtig;
ervaren===ervaren;ervarene;
opaak===opaak;
leesbaar===leesbaar;leesbare;
Litouws===Litouws;
geaxeerd===geaxeerd;
ondergronds===ondergronds;
Georgisch===Georgisch;
aimabel===aimabel;aimabele;aimabeler;
compleet===compleet;
dringend===dringend;dringende;
oplosbaar===oplosbaar;oplosbaarder;oplosbaars;oplosbaarst;oplosbare;
triomfant===triomfant;triomfanter;triomfantst;
klote===klote;
ingeworteld===ingeworteld;ingewortelde;
schappelijk===schappelijk;schappelijke;schappelijker;schappelijks;schappelijkst;
laagdrempelig===laagdrempelig;laagdrempelige;laagdrempeliger;laagdrempeligs;laagdrempeligst;
taps===taps;tapse;
endemisch===endemisch;
excessief===excessief;excessiefs;excessiefst;excessieve;excessiever;
hormonaal===hormonaal;
verfijnd===verfijnd;
wijd===wijd;wijde;wijds;
haaks===haaks;haakse;
regelmatig===regelmatig;
geducht===geducht;
links===links;linkser;
Aranees===Aranees;
fotografisch===fotografisch;
zuur===zuur;
positief===positief;positiefst;positieve;positiever;
wijs===wijs;
grijsharig===grijsharig;
Maleis===Maleis;
koninklijk===koninklijk;koninklijke;
geprepareerd===geprepareerd;geprepareerde;
defect===defect;
inactief===inactief;
schor===schor;schorst;
effectief===effectief;effectiefst;effectiever;
lichtbruin===lichtbruin;
herbergzaam===herbergzaam;
Babylonisch===Babylonisch;Babylonische;
beroepsmatig===beroepsmatig;
omstreden===omstreden;
drinkbaar===drinkbaar;drinkbare;
bijectief===bijectief;
duchtig===duchtig;duchtige;duchtiger;duchtigs;duchtigst;
tragisch===tragisch;tragische;tragischer;tragischt;
verdovend===verdovend;
digitaal===digitaal;digitale;
getrouwd===getrouwd;
Frans===Frans;Franse;
massief===massief;massiefst;massieve;
kritisch===kritisch;kritische;
koolhydraatrijk===koolhydraatrijk;
Albanees===Albanees;
nijdig===nijdig;nijdige;nijdiger;nijdigs;nijdigst;
subatomair===subatomair;subatomaire;subatomairs;
dramatisch===dramatisch;dramatische;
verdwaald===verdwaald;
ideologisch===ideologisch;ideologische;
gratuit===gratuit;
kras===kras;
vermist===vermist;vermiste;
natuurlijk===natuurlijk;natuurlijke;natuurlijker;natuurlijkst;
krap===krap;kraps;
beklagenswaardig===beklagenswaardig;beklagenswaardiger;beklagenswaardigst;
opvallend===opvallend;opvallende;
retorisch===retorisch;retorische;
schuldig===schuldig;schuldige;schuldiger;schuldigs;schuldigst;
traumatisch===traumatisch;
wereldberoemd===wereldberoemd;wereldberoemde;
bits===bits;
farmaceutisch===farmaceutisch;farmaceutische;
Haïtiaans===Haïtiaans;
termsgewijs===termsgewijs;termsgewijze;
tiende===tiende;
munificent===munificent;
subjectief===subjectief;subjectiefst;subjectieve;subjectiever;
alledaags===alledaags;
ongelijkmatig===ongelijkmatig;
geaffecteerd===geaffecteerd;geaffecteerder;geaffecteerdst;
vertwijfeld===vertwijfeld;
spiksplinter===spiksplinter;
wispelturig===wispelturig;
bedlegerig===bedlegerig;
corrosief===corrosief;corrosieve;
melodisch===melodisch;melodische;melodischer;melodischt;
krachtig===krachtig;krachtige;krachtiger;krachtigst;
geheim===geheim;
gevangen===gevangen;
zeeziek===zeeziek;
pleisteren===pleisteren;
samenhangend===samenhangend;samenhangende;
weerbarstig===weerbarstig;
lusteloos===lusteloos;
titulair===titulair;
werkloos===werkloos;werkeloos;werkloze;
liberaal===liberaal;liberaalst;liberale;
kostenloos===kostenloos;
aanstaand===aanstaand;aanstaande;
nalatig===nalatig;nalatige;nalatiger;nalatigs;nalatigst;
hoogpolig===hoogpolig;
depressief===depressief;depressiefs;depressiefst;depressieve;depressiever;
voorgaand===voorgaand;
cool===cool;coole;
Hawaïaans===Hawaïaans;
aflijvig===aflijvig;
theologisch===theologisch;theologische;
log===log;
volgroeid===volgroeid;
centristisch===centristisch;
behendig===behendig;behendiger;behendigst;
Aragonees===Aragonees;
los===los;lost;
baat===baat;
statig===statig;
onplezierig===onplezierig;onplezieriger;onplezierigst;
vreemd===vreemd;vreemde;vreemder;vreemds;vreemdst;
Zeeuws===Zeeuws;Zeeuwse;Zeeuwser;Zeeuwst;
bevoegd===bevoegd;
ondergeschikt===ondergeschikt;ondergeschikte;
gewezen===gewezen;
driest===driest;driester;
groenig===groenig;groeniger;groenigst;
afvallig===afvallig;
onderwijskundig===onderwijskundig;
boeiend===boeiend;
sierlijk===sierlijk;
stroef===stroef;stroefst;
trots===trots;trotse;
bevaarbaar===bevaarbaar;bevaarbare;
besteedbaar===besteedbaar;
smal===smal;
achterbaks===achterbaks;
vlaskleurig===vlaskleurig;
wetteloos===wetteloos;
opvliegend===opvliegend;opvliegende;
liturgisch===liturgisch;
gruwelijk===gruwelijk;gruwelijker;gruwelijkst;
doorwrocht===doorwrocht;
grootscheeps===grootscheeps;grootscheepse;grootscheepser;grootscheepst;
enkelvoudig===enkelvoudig;
gering===gering;geringe;geringer;geringst;
beheersbaar===beheersbaar;
uitneembaar===uitneembaar;
kruiselings===kruiselings;kruiselingse;
behinderd===behinderd;
potentieel===potentieel;potentiële;
soortgelijk===soortgelijk;soortgelijker;soortgelijkst;
bruinig===bruinig;bruiniger;bruinigst;
Iberisch===Iberisch;
geliefd===geliefd;
problematisch===problematisch;problematischer;problematischt;
naamwoordelijk===naamwoordelijk;
vundig===vundig;
dwaas===dwaas;dwaast;
doorsnee===doorsnee;
satanisch===satanisch;
ongetrouwd===ongetrouwd;ongetrouwde;
onbeschrijfelijk===onbeschrijfelijk;
Wit-Russisch===Wit-Russisch;
gedragen===gedragen;
definitief===definitief;definitieve;
bloedheet===bloedheet;
langwerpig===langwerpig;
katachtig===katachtig;katachtige;
maanogig===maanogig;
ongestoord===ongestoord;ongestoorde;ongestoorder;ongestoords;ongestoordst;
uitgestorven===uitgestorven;
vrouwelijk===vrouwelijk;vrouwelijke;
laatst===laatst;laatste;
respectief===respectief;
symbolisch===symbolisch;
buitensporig===buitensporig;buitensporige;buitensporiger;buitensporigs;buitensporigst;
kaal===kaal;
blijkbaar===blijkbaar;blijkbaarder;blijkbaarst;
mutageen===mutageen;mutagene;
naïef===naïef;
zwaar===zwaar;zwaarst;
zorgeloos===zorgeloos;zorgeloost;zorgeloze;zorgelozer;
paniekerig===paniekerig;paniekerige;paniekeriger;paniekerigst;
aanwezig===aanwezig;aanwezige;
monotheïstisch===monotheïstisch;monotheïstische;
verliefd===verliefd;
wakker===wakker;
militair===militair;militaire;
roemrucht===roemrucht;
ontzield===ontzield;
antarctisch===antarctisch;
dakloos===dakloos;dakloze;
lastig===lastig;lastiger;lastigst;
extra===extra;
uiteindelijk===uiteindelijk;
kritiek===kritiek;kritieke;kritieker;kritiekst;
bijzonder===bijzonder;bijzonderder;bijzonderst;
linkshandig===linkshandig;
bloeddorstig===bloeddorstig;bloeddorstige;bloeddorstiger;bloeddorstigs;bloeddorstigst;
vinnig===vinnig;
onwillekeurig===onwillekeurig;onwillekeuriger;onwillekeurigst;
hypocriet===hypocriet;
aanverwant===aanverwant;aanverwante;
cultureel===cultureel;culturele;
opeenvolgend===opeenvolgend;opeenvolgende;
vrijstaand===vrijstaand;
ijzerenheinig===ijzerenheinig;
gevoelig===gevoelig;gevoeliger;gevoeligst;
bewoonbaar===bewoonbaar;
kwastvinnig===kwastvinnig;
ziekelijk===ziekelijk;
compositorisch===compositorisch;
plezant===plezant;plezanter;plezantst;
summier===summier;
failliet===failliet;
objectief===objectief;
Spartaans===Spartaans;
roodharig===roodharig;roodharige;
onuitstaanbaar===onuitstaanbaar;
sterfelijk===sterfelijk;
betrokken===betrokken;
aloud===aloud;aloude;
knetter===knetter;
blank===blank;
eerste===eerste;
niet-gewelddadig===niet-gewelddadig;
lek===lek;leks;
ongemakkelijk===ongemakkelijk;
Hondurees===Hondurees;
opgewonden===opgewonden;
wantrouwig===wantrouwig;wantrouwiger;wantrouwigst;
akelig===akelig;akeliger;akeligst;
onverzettelijk===onverzettelijk;
jolig===jolig;joliger;joligst;
aangepast===aangepast;aangepaste;
ongedeerd===ongedeerd;
kreupel===kreupel;
priesterlijk===priesterlijk;
universeel===universeel;universele;
oorlogszuchtig===oorlogszuchtig;
verenigbaar===verenigbaar;
logisch===logisch;logische;
figuurlijk===figuurlijk;
onheilspellend===onheilspellend;onheilspellende;
gebrekkig===gebrekkig;gebrekkige;
kostelijk===kostelijk;kostelijke;kostelijker;kostelijks;kostelijkst;
voorwaardelijk===voorwaardelijk;
krankjorum===krankjorum;krankjorume;krankjorumer;krankjorums;krankjorumst;
duizelingwekkend===duizelingwekkend;duizelingwekkender;duizelingwekkendst;
winters===winters;
gefortuneerd===gefortuneerd;
kalm===kalm;
onlosmakelijk===onlosmakelijk;
angstaanjagend===angstaanjagend;
goed===goed;goede;goeds;goei;
toevallig===toevallig;
hypothetisch===hypothetisch;hypothetische;
oostwaarts===oostwaarts;
spierwit===spierwit;
overmatig===overmatig;
Tataars===Tataars;
opzienbarend===opzienbarend;opzienbarende;
moeilijk===moeilijk;moeilijke;moeilijker;moeilijkst;
dodelijk===dodelijk;
opperste===opperste;
persoonlijk===persoonlijk;
gehuwd===gehuwd;gehuwde;
zelfgemaakt===zelfgemaakt;zelfgemaakte;
puntig===puntig;puntige;puntiger;puntigs;puntigst;
knapperig===knapperig;knapperige;knapperiger;knapperigs;knapperigst;
tweejaarlijks===tweejaarlijks;
onpaar===onpaar;
verstrooid===verstrooid;
presiderend===presiderend;
krank===krank;kranke;kranker;kranks;krankst;
onveranderlijk===onveranderlijk;onveranderlijker;onveranderlijkst;
volwaardig===volwaardig;
generiek===generiek;
Beiers===Beiers;Beierser;Beierst;
doorschijnend===doorschijnend;doorschijnende;
bijdehand===bijdehand;
dankbaar===dankbaar;
zwartverdiend===zwartverdiend;
smeuïg===smeuïg;smeuïger;smeuïgst;
achterliggend===achterliggend;achterliggende;
massaal===massaal;massaals;massaalst;massale;
bros===bros;
ontroostbaar===ontroostbaar;
streng===streng;strenge;strenger;strengst;
representatief===representatief;representatiefst;representatiever;
geel===geel;geels;
wederkerend===wederkerend;wederkerende;
geen===geen;
voorwaarts===voorwaarts;
metroseksueel===metroseksueel;
benodigd===benodigd;benodigde;
onvermoeid===onvermoeid;onvermoeide;
heerlijk===heerlijk;heerlijke;heerlijker;heerlijks;heerlijkst;
algemeen===algemeen;algemene;
Oudsaksisch===Oudsaksisch;
gespierd===gespierd;
gekeerd===gekeerd;gekeerde;gekeerder;gekeerds;gekeerdst;
belezen===belezen;
verenigd===verenigd;verenigde;
westwaarts===westwaarts;
maf===maf;
incongruent===incongruent;
schemerig===schemerig;schemeriger;schemerigst;
vrijer===vrijer;vrijere;
mal===mal;
publiek===publiek;
organoleptisch===organoleptisch;
terloops===terloops;
nader===nader;
graatmager===graatmager;
humoristisch===humoristisch;
kostbaar===kostbaar;
mat===mat;
excentriek===excentriek;
evenwijdig===evenwijdig;
efficiënt===efficiënt;efficiënter;efficiëntst;
onwettig===onwettig;
dada===dada;
Aroemeens===Aroemeens;Aroemeenser;Aroemeenst;
ovaal===ovaal;
onovergankelijk===onovergankelijk;
wisseltonig===wisseltonig;
verschrikkelijk===verschrikkelijk;
gedaan===gedaan;
Belgisch===Belgisch;Belgische;
levensecht===levensecht;
vergeefs===vergeefs;vergeefse;vergeefser;vergeefst;
wagenziek===wagenziek;
Duffels===Duffels;
goniometrisch===goniometrisch;goniometrische;
heptatonisch===heptatonisch;heptatonische;
agrarisch===agrarisch;
lukraak===lukraak;lukrake;
smerig===smerig;smerige;
Zoeloe===Zoeloe;
sluw===sluw;
interessant===interessant;interessanter;interessants;interessantst;
geil===geil;
onophoudelijk===onophoudelijk;onophoudelijke;
eigenlijk===eigenlijk;eigenlijke;
alternatief===alternatief;alternatieve;
spits===spits;spitse;spitser;spitst;
transitief===transitief;
onvoorwaardelijk===onvoorwaardelijk;
briljant===briljant;briljanter;briljantst;
illegaal===illegaal;
onveilig===onveilig;onveiligst;
oneffen===oneffen;
constructivistisch===constructivistisch;
ultramarijn===ultramarijn;
onzinnig===onzinnig;onzinnige;onzinniger;onzinnigst;
grimmig===grimmig;grimmige;grimmiger;grimmigs;grimmigst;
keihard===keihard;
peervormig===peervormig;peervormige;
insensibel===insensibel;
parallel===parallel;parallelle;parallels;
uniform===uniform;
Chileens===Chileens;Chileense;
intellectueel===intellectueel;intellectueelst;intellectuele;intellectueler;
geblokkeerd===geblokkeerd;geblokkeerde;
verschuldigd===verschuldigd;
kortgerokt===kortgerokt;
sadistisch===sadistisch;
bedaard===bedaard;
onverbeterlijk===onverbeterlijk;
generaal===generaal;
zymogeen===zymogeen;
vlak===vlak;
kwadraat===kwadraat;
negende===negende;
erkend===erkend;erkende;
getralied===getralied;
geheimzinnig===geheimzinnig;geheimzinniger;geheimzinnigst;
inelastisch===inelastisch;
onverwacht===onverwacht;onverwachte;onverwachter;onverwachtst;
hemelhoog===hemelhoog;
lui===lui;
Sloveens===Sloveens;
doorzichtig===doorzichtig;doorzichtige;
onhoorbaar===onhoorbaar;
Minoïsch===Minoïsch;Minoïsche;
behaaglijk===behaaglijk;behaaglijker;behaaglijkst;
danig===danig;
roodgloeiend===roodgloeiend;
smalend===smalend;
karig===karig;kariger;karigst;
fataal===fataal;
instabiel===instabiel;instabiele;instabieler;instabiels;instabielst;
breekbaar===breekbaar;breekbaarder;breekbaarst;
topologisch===topologisch;
effen===effen;
aangenaam===aangenaam;aangenaamst;aangename;aangenamer;
oostelijk===oostelijk;oostelijke;
Carthaags===Carthaags;
concreet===concreet;concrete;
onontbeerlijk===onontbeerlijk;
stronken===stronken;
houdbaar===houdbaar;houdbaarder;houdbaarst;houdbare;
verscheiden===verscheiden;verscheidene;
extern===extern;
onwaar===onwaar;
bevederd===bevederd;
hydrostatisch===hydrostatisch;hydrostatische;
narrig===narrig;narriger;narrigst;
Nederlands===Nederlands;Nederlandse;
Nigeriaans===Nigeriaans;Nigeriaanse;
luchtig===luchtig;
stalen===stalen;
indiscreet===indiscreet;
gezamenlijk===gezamenlijk;gezamenlijke;
sceptisch===sceptisch;
boeddhistisch===boeddhistisch;boeddhistische;
romantisch===romantisch;romantische;
bloedig===bloedig;
sluik===sluik;
telbaar===telbaar;
doordeweeks===doordeweeks;
Brits===Brits;Britse;
collectief===collectief;collectieve;
dichtbij===dichtbij;dichterbij;
dilettantisch===dilettantisch;dilettantische;
onderbetaald===onderbetaald;onderbetaalde;
anglicaans===anglicaans;anglicaanse;
bekrompen===bekrompen;
fricatief===fricatief;
luchtziek===luchtziek;
vervallen===vervallen;
bekoorlijk===bekoorlijk;
gedegen===gedegen;
sacherijnig===sacherijnig;sacherijnige;
eerzuchtig===eerzuchtig;
Germaans===Germaans;
lichtgrijs===lichtgrijs;
asociaal===asociaal;asociaals;asociaalst;asociale;
drassig===drassig;
monochroom===monochroom;
gravitationeel===gravitationeel;gravitationele;
waardevol===waardevol;waardevolle;waardevoller;waardevols;waardevolst;
lauw===lauw;
geus===geus;
afwezig===afwezig;afwezige;
ouderlijk===ouderlijk;
immanent===immanent;
gaafrandig===gaafrandig;
olijfgroen===olijfgroen;
eeuwig===eeuwig;eeuwige;
onmogelijk===onmogelijk;onmogelijke;
schamper===schamper;schamperder;schamperst;
rekels===rekels;
onbehaaglijk===onbehaaglijk;
comfortabel===comfortabel;
hardgekookt===hardgekookt;
tenger===tenger;tengerst;
multilateraal===multilateraal;
vreesaanjagend===vreesaanjagend;
Joegoslavisch===Joegoslavisch;Joegoslavische;
intelligent===intelligent;intelligentst;
dor===dor;
dom===dom;
dol===dol;
gelaarsd===gelaarsd;
amyotrofisch===amyotrofisch;
onfatsoenlijk===onfatsoenlijk;
vijftiende===vijftiende;
psychiatrisch===psychiatrisch;
dynastiek===dynastiek;dynastieke;
vrijgevig===vrijgevig;vrijgeviger;vrijgevigst;
bijgelovig===bijgelovig;
bacterieel===bacterieel;bacteriële;
moe===moe;
antiferromagnetisch===antiferromagnetisch;
cumulatief===cumulatief;
lekker===lekker;lekkere;lekkers;lekkerst;
ongelezen===ongelezen;
uiteenlopend===uiteenlopend;
zonnig===zonnig;zonnige;zonniger;zonnigst;
ongunstig===ongunstig;
centrumlinks===centrumlinks;centrumlinkse;
spectaculair===spectaculair;spectaculaire;
eerlijk===eerlijk;eerlijke;eerlijker;eerlijks;eerlijkst;
begrensd===begrensd;begrensde;
krankzinnig===krankzinnig;krankzinnige;krankzinniger;krankzinnigs;krankzinnigst;
dweperig===dweperig;dweperiger;dweperigst;
aangeboren===aangeboren;
kies===kies;
nationalistisch===nationalistisch;nationalistischer;nationalistischt;
onzichtbaar===onzichtbaar;onzichtbare;
gerechtigd===gerechtigd;gerechtigde;
onverslaanbaar===onverslaanbaar;onverslaanbaarder;onverslaanbaarst;
teder===teder;tedere;teders;tederst;
Faeröers===Faeröers;
gelig===gelig;
fijngevoelig===fijngevoelig;fijngevoeliger;fijngevoeligst;
slap===slap;slaps;
brak===brak;
sjagerijnig===sjagerijnig;
dof===dof;
vlug===vlug;
tijdig===tijdig;tijdiger;tijdigst;
bejaard===bejaard;
piekerig===piekerig;
hoofdletterongevoelig===hoofdletterongevoelig;
slee===slee;
halsstarrig===halsstarrig;halsstarrige;halsstarriger;halsstarrigs;halsstarrigst;
bergachtig===bergachtig;bergachtige;
muf===muf;
hoffelijk===hoffelijk;
toekomstig===toekomstig;toekomstige;
sedentair===sedentair;
mondiaal===mondiaal;mondiale;
onderstaand===onderstaand;
vlot===vlot;vlots;
Catalaans===Catalaans;Catalaanse;Catalaanser;Catalaanst;
leegstaand===leegstaand;
fetisjistisch===fetisjistisch;
geniaal===geniaal;geniaals;geniaalst;geniale;
dwangmatig===dwangmatig;
zoetzuur===zoetzuur;
geniepig===geniepig;geniepige;geniepiger;geniepigs;geniepigst;
schatrijk===schatrijk;schatrijke;schatrijker;schatrijks;schatrijkst;
dun===dun;
mislukt===mislukt;mislukte;
attent===attent;attenter;attentst;
schuw===schuw;schuwer;schuwst;
duf===duf;
Oudfrankisch===Oudfrankisch;
grappig===grappig;grappiger;grappigst;
levensgevaarlijk===levensgevaarlijk;
gecontroleerd===gecontroleerd;
tof===tof;tofs;
onnozel===onnozel;
talloos===talloos;talloost;talloze;
bedreven===bedreven;bedrevener;bedrevens;bedrevenst;
doorvallend===doorvallend;
bekend===bekend;bekende;bekender;bekendst;
overvloedig===overvloedig;
attributief===attributief;
Lets===Lets;Letse;Letst;
lang===lang;lange;
zinnenprikkelend===zinnenprikkelend;zinnenprikkelende;
pikant===pikant;
haarscherp===haarscherp;haarscherpe;haarscherper;haarscherps;haarscherpst;
willekeurig===willekeurig;willekeurige;willekeuriger;willekeurigst;
weids===weids;weidser;weidst;
ontelbaar===ontelbaar;ontelbare;
algebraïsch===algebraïsch;algebraïsche;
berouwvol===berouwvol;
nuchter===nuchter;nuchterder;nuchterst;
bruinachtig===bruinachtig;bruinachtige;
draagbaar===draagbaar;
informeel===informeel;
onaantrekkelijk===onaantrekkelijk;onaantrekkelijke;onaantrekkelijker;onaantrekkelijks;onaantrekkelijkst;
sinister===sinister;
rustig===rustig;rustiger;rustigst;
simpel===simpel;simpele;simpeler;simpelst;
geoorloofd===geoorloofd;
hondstrouw===hondstrouw;
kwetsbaar===kwetsbaar;kwetsbaarder;kwetsbaars;kwetsbaarst;kwetsbare;
gehuisvest===gehuisvest;
gehoorzaam===gehoorzaam;gehoorzaamst;gehoorzamer;
piepklein===piepklein;piepkleiner;piepkleinst;
barvoets===barvoets;
adoptief===adoptief;
slim===slim;
onverdraaglijk===onverdraaglijk;
scandaleus===scandaleus;
gelijkmatig===gelijkmatig;
bloedgeil===bloedgeil;
eenentwintigste===eenentwintigste;
hertogelijk===hertogelijk;
onervaren===onervaren;
fleurig===fleurig;fleuriger;fleurigst;
alert===alert;
ontspannen===ontspannen;
ethisch===ethisch;ethischer;
onwel===onwel;
conventioneel===conventioneel;conventioneelst;conventioneler;
technisch===technisch;technische;
talrijk===talrijk;talrijke;
aanpasbaar===aanpasbaar;aanpasbare;
blaauw===blaauw;
noordwestelijk===noordwestelijk;noordwestelijker;noordwestelijkst;
kennelijk===kennelijk;
ondankbaar===ondankbaar;
klein===klein;kleine;kleiner;kleins;kleinst;
laat===laat;
taai===taai;taaie;taais;
allergisch===allergisch;
zwart===zwart;zwarte;zwarter;zwartst;
heldhaftig===heldhaftig;heldhaftige;heldhaftiger;heldhaftigs;heldhaftigst;
noest===noest;
haalbaar===haalbaar;
laag===laag;
schijnbaar===schijnbaar;schijnbare;
doodkalm===doodkalm;
arctisch===arctisch;arctische;
mis===mis;
rigide===rigide;rigider;
ongelijk===ongelijk;
slaperig===slaperig;
dreigend===dreigend;dreigende;
kaduuk===kaduuk;
filatelistisch===filatelistisch;
Victoriaans===Victoriaans;
Fins===Fins;Finse;
elektronisch===elektronisch;elektronische;elektronischer;elektronischt;
Ripuarisch===Ripuarisch;
Zwitsers===Zwitsers;Zwitserse;
verdraaid===verdraaid;
hatelijk===hatelijk;hatelijke;hatelijker;hatelijks;hatelijkst;
kunstmatig===kunstmatig;kunstmatige;kunstmatiger;kunstmatigst;
territoriaal===territoriaal;territoriale;
Italiaans===Italiaans;Italiaanse;
pejoratief===pejoratief;pejoratiefst;pejoratiever;
bovenwerkelijk===bovenwerkelijk;
crèmekleurig===crèmekleurig;
onaangesproken===onaangesproken;
eindeloos===eindeloos;
heus===heus;
elliptisch===elliptisch;elliptische;
eenvormig===eenvormig;
machtig===machtig;machtiger;machtigst;
feestelijk===feestelijk;
christendemocratisch===christendemocratisch;christendemocratische;
constructief===constructief;
kreeftachtig===kreeftachtig;
ordelijk===ordelijk;
verdergaand===verdergaand;
dik===dik;
goddelijk===goddelijk;
juridisch===juridisch;juridische;
jeugdig===jeugdig;jeugdige;jeugdiger;jeugdigs;jeugdigst;
luthers===luthers;lutherse;lutherser;lutherst;
godsdienstig===godsdienstig;godsdienstige;
beknopt===beknopt;
geleidelijk===geleidelijk;
dyslectisch===dyslectisch;
ranzig===ranzig;ranzige;ranziger;ranzigs;ranzigst;
mistig===mistig;mistiger;mistigst;
krom===krom;
donkergroen===donkergroen;
gekarteld===gekarteld;
inbegrepen===inbegrepen;
vulkanisch===vulkanisch;vulkanische;
opstandig===opstandig;opstandige;opstandiger;opstandigst;
