achteraf===achteraf;
liever===liever;
stelselmatig===stelselmatig;
wellevend===wellevend;
achteraan===achteraan;erachteraan;
uren===uren;
stedewaarts===stedewaarts;
extreem===extreem;
juist===juist;
benedenwaarts===benedenwaarts;
jep===jep;
over===over;
herhaaldelijk===herhaaldelijk;
massaal===massaal;
anderszins===anderszins;
totaal===totaal;
integendeel===integendeel;
heden===heden;
bijna===bijna;
vooraf===vooraf;
geleden===geleden;
slechts===slechts;
overigens===overigens;
heen===heen;
vooral===vooral;
tussenbeide===tussenbeide;
altoos===altoos;
binnenstebuiten===binnenstebuiten;
heel===heel;
voorwaarts===voorwaarts;
spoedig===spoedig;
alleen===alleen;
hopelijk===hopelijk;
weeral===weeral;
erheen===erheen;
alsjeblieft===alsjeblieft;
zuidwestelijk===zuidwestelijk;
teruguit===teruguit;
meer===meer;
eervol===eervol;
neer===neer;
geografisch===geografisch;
noordwaarts===noordwaarts;
nagenoeg===nagenoeg;
speciaal===speciaal;
veel===veel;
fel===fel;
inwaarts===inwaarts;
halfweg===halfweg;
uniek===uniek;
anders===anders;
oubollig===oubollig;
ogenschijnlijk===ogenschijnlijk;
bij===bij;
gaarne===gaarne;
daadwerkelijk===daadwerkelijk;
tegemoet===tegemoet;
eerst===eerst;
omver===omver;
achter===achter;erachter;
enzovoorts===enzovoorts;
loefwaarts===loefwaarts;
tussendoor===tussendoor;daartussendoor;ertussendoor;hiertussendoor;waartussendoor;
ineens===ineens;
destijds===destijds;
andersom===andersom;
immer===immer;
net===net;
vet===vet;
gemakkelijk===gemakkelijk;
nimmer===nimmer;
zielsveel===zielsveel;
westwaarts===westwaarts;
derhalve===derhalve;
zachtaardig===zachtaardig;
straal===straal;
gedeeltelijk===gedeeltelijk;
noodzakelijk===noodzakelijk;
voortdurend===voortdurend;
wen===wen;
onbedoeld===onbedoeld;
hoopvol===hoopvol;
loom===loom;
nee===nee;neen;
terloops===terloops;
wel===wel;
nader===nader;
marginaal===marginaal;
weg===weg;
nauwelijks===nauwelijks;
vooruit===vooruit;
ronduit===ronduit;
uit-en-te-na===uit-en-te-na;uit-en-ter-na;
geregeld===geregeld;
onafhankelijk===onafhankelijk;
zolang===zolang;
tamelijk===tamelijk;
elkander===elkander;
mede===mede;
zodanig===zodanig;
verderop===verderop;
dada===dada;
navenant===navenant;
reeds===reeds;
er===er;
momenteel===momenteel;
liefst===liefst;
zeer===zeer;
onmiddellijk===onmiddellijk;
bijgevolg===bijgevolg;
echt===echt;
genetisch===genetisch;
hoofdzakelijk===hoofdzakelijk;
overheen===overheen;eroverheen;
overal===overal;
meteen===meteen;
optisch===optisch;
alreeds===alreeds;
uiterlijk===uiterlijk;
doch===doch;
afgezonderd===afgezonderd;
wettelijk===wettelijk;
verschrikkelijk===verschrikkelijk;
verrassend===verrassend;
maandelijks===maandelijks;
barrevoets===barrevoets;
frivool===frivool;
opzij===opzij;
grotendeels===grotendeels;
vanochtend===vanochtend;
doelbewust===doelbewust;
gisteravond===gisteravond;
circa===circa;
vergeefs===vergeefs;
veilig===veilig;
onlangs===onlangs;
dadelijk===dadelijk;
bovendien===bovendien;
aanvankelijk===aanvankelijk;
gewelddadig===gewelddadig;
morgen===morgen;
immers===immers;
daar===daar;
helemaal===helemaal;
tevergeefs===tevergeefs;
hoor===hoor;
langzaam===langzaam;
ietsje===ietsje;
voorgoed===voorgoed;
vaak===vaak;
steeds===steeds;
onophoudelijk===onophoudelijk;
windwaarts===windwaarts;
ruwweg===ruwweg;
dan===dan;
waarschijnlijk===waarschijnlijk;
eigenlijk===eigenlijk;
doorheen===doorheen;erdoorheen;
mee===mee;
van===van;
onrechtstreeks===onrechtstreeks;
omtrent===omtrent;eromtrent;
daartevoren===daartevoren;
hartstikke===hartstikke;
normaal===normaal;
retour===retour;
zeewaarts===zeewaarts;
midden===midden;
voorlopig===voorlopig;
plotseling===plotseling;
vreselijk===vreselijk;
rond===rond;
elderwaarts===elderwaarts;
pas===pas;
bovenwaarts===bovenwaarts;
nadien===nadien;
namelijk===namelijk;
achterwaarts===achterwaarts;
bijster===bijster;
graf===graf;
intijds===intijds;
terecht===terecht;
neder===neder;
sowieso===sowieso;
behoorlijk===behoorlijk;
terugwaarts===terugwaarts;
rechtop===rechtop;
voornamelijk===voornamelijk;
amechtig===amechtig;
noord===noord;
pal===pal;
mitsdien===mitsdien;
driemaal===driemaal;
vanmorgen===vanmorgen;
uiterst===uiterst;
vrij===vrij;
erop===erop;
moeiteloos===moeiteloos;
aaneen===aaneen;
al===al;
bedaard===bedaard;
zoniet===zoniet;
vlak===vlak;
enigszins===enigszins;
nodig===nodig;
neerwaarts===neerwaarts;
zat===zat;
af===af;
nu===nu;
geheel===geheel;
dood===dood;
enerzijds===enerzijds;
door===door;
gastvrij===gastvrij;
nooit===nooit;
onverwacht===onverwacht;
bazig===bazig;
lelijk===lelijk;
opmerkelijk===opmerkelijk;
overweg===overweg;
hemelhoog===hemelhoog;
zoo===zoo;
eenmaal===eenmaal;
waar===waar;
ontzettend===ontzettend;
om===om;
telkens===telkens;
on===on;
her===her;
gewoonweg===gewoonweg;
inhoudelijk===inhoudelijk;
onverhoopt===onverhoopt;
rechtsaf===rechtsaf;
schandelijk===schandelijk;
danig===danig;
op===op;
toch===toch;
oraal===oraal;
tevoren===tevoren;
smalend===smalend;
aan===aan;
alvast===alvast;
voorheen===voorheen;
wanneer===wanneer;
waarachtig===waarachtig;
overdag===overdag;
voorbij===voorbij;ervoorbij;
eergisteren===eergisteren;
bar===bar;
naartoe===naartoe;ernaartoe;
oost===oost;
wederom===wederom;
effen===effen;effe;
urenlang===urenlang;
compleet===compleet;
zover===zover;
stroomafwaarts===stroomafwaarts;
thans===thans;
omheen===omheen;eromheen;
terug===terug;
huiswaarts===huiswaarts;
nipt===nipt;
terdege===terdege;
zojuist===zojuist;
sprekend===sprekend;
louter===louter;
buitenaf===buitenaf;
traditioneel===traditioneel;
blindelings===blindelings;
feitelijk===feitelijk;
linksom===linksom;
verbluffend===verbluffend;
ziek===ziek;
tuurlijk===tuurlijk;
achtereenvolgens===achtereenvolgens;
toen===toen;
tijdelijk===tijdelijk;
links===links;
boven===boven;erboven;
binnen===binnen;erbinnen;
onderaan===onderaan;
mateloos===mateloos;
's==='s;
wijs===wijs;
opnieuw===opnieuw;
ongeveer===ongeveer;
dus===dus;
desnoods===desnoods;
eens===eens;
alom===alom;
onderwijl===onderwijl;
uitermate===uitermate;
zuidwest===zuidwest;
vriendelijk===vriendelijk;
antropologisch===antropologisch;
terzijde===terzijde;
finaal===finaal;
straks===straks;
getweeën===getweeën;
vervolgens===vervolgens;
maar===maar;
dikwijls===dikwijls;
verreweg===verreweg;
anderzijds===anderzijds;
eruit===eruit;
vanmiddag===vanmiddag;
ginds===ginds;
deels===deels;
overeind===overeind;
zijdelings===zijdelings;
ijlings===ijlings;
vooralsnog===vooralsnog;
echter===echter;
enzovoort===enzovoort;
zelfs===zelfs;
niettemin===niettemin;
hierop===hierop;
uyt===uyt;
overeen===overeen;
nogmaals===nogmaals;
idem===idem;
gemeen===gemeen;
spontaan===spontaan;
hooguit===hooguit;
beneden===beneden;
buitenwaarts===buitenwaarts;
evenmin===evenmin;
zeker===zeker;
principieel===principieel;
helaas===helaas;
zodoende===zodoende;
aldaar===aldaar;
dramatisch===dramatisch;
weinig===weinig;
meermalen===meermalen;
binnenkort===binnenkort;
indertijd===indertijd;
weleer===weleer;
trouwens===trouwens;
halverwege===halverwege;
natuurlijk===natuurlijk;
noordoost===noordoost;
wat===wat;
tegelijk===tegelijk;
eerder===eerder;
jarenlang===jarenlang;
eeuwig===eeuwig;
moeizaam===moeizaam;
alsmaar===alsmaar;
bepaald===bepaald;
allengs===allengs;
dito===dito;
waarop===waarop;
termsgewijs===termsgewijs;
tenslotte===tenslotte;
rotsvast===rotsvast;
is===is;
onbehaaglijk===onbehaaglijk;
misschien===misschien;
gisteren===gisteren;
welwillend===welwillend;
verwonderlijk===verwonderlijk;
ongelijkmatig===ongelijkmatig;
dermate===dermate;
ongetwijfeld===ongetwijfeld;
helwaarts===helwaarts;
in===in;
rechtdoor===rechtdoor;
ietwat===ietwat;
geheim===geheim;
krachtig===krachtig;
noordwest===noordwest;
tegen===tegen;ertegen;
menigmaal===menigmaal;
ja===ja;
kortom===kortom;
halfstok===halfstok;
gaandeweg===gaandeweg;
eeuwenlang===eeuwenlang;
waarheen===waarheen;
thuis===thuis;
nadrukkelijk===nadrukkelijk;
adagio===adagio;
ooit===ooit;
contant===contant;
vanaf===vanaf;ervanaf;
gelukkig===gelukkig;
beurtelings===beurtelings;
beetje===beetje;
opwaarts===opwaarts;
onomstotelijk===onomstotelijk;
tezamen===tezamen;
recentelijk===recentelijk;
achteruit===achteruit;
emfatisch===emfatisch;
zuidoostelijk===zuidoostelijk;
abusievelijk===abusievelijk;
gisterenavond===gisterenavond;
doorlopend===doorlopend;
aardig===aardig;
buiten===buiten;erbuiten;
hemelwaarts===hemelwaarts;
ternauwernood===ternauwernood;
strikt===strikt;
onberispelijk===onberispelijk;
gelijk===gelijk;
uitdrukkelijk===uitdrukkelijk;
bijtijds===bijtijds;
desgevraagd===desgevraagd;
schuin===schuin;
zozeer===zozeer;
betreurenswaardig===betreurenswaardig;
gewis===gewis;
hier===hier;
tenminste===tenminste;
weliswaar===weliswaar;
tjokvol===tjokvol;
zijwaarts===zijwaarts;
ondersteboven===ondersteboven;
bepaaldelijk===bepaaldelijk;
geestelijk===geestelijk;
haast===haast;
staatkundig===staatkundig;
inzonderheid===inzonderheid;
hoe===hoe;
volzet===volzet;
nogal===nogal;
daags===daags;
alweer===alweer;
onverrichterzake===onverrichterzake;
best===best;
meermaals===meermaals;
vanavond===vanavond;
periodiek===periodiek;
hard===hard;
teloor===teloor;
netto===netto;
direct===direct;
redelijkerwijs===redelijkerwijs;
later===later;
beroepshalve===beroepshalve;
voorop===voorop;
opzettelijk===opzettelijk;
exclusief===exclusief;
jup===jup;
optimistisch===optimistisch;
tegenover===tegenover;ertegenover;
weer===weer;weder;
plots===plots;
onophoudend===onophoudend;
ginder===ginder;
vanzelf===vanzelf;
samen===samen;
daarstraks===daarstraks;
ditmaal===ditmaal;
te===te;
jawel===jawel;
absoluut===absoluut;
zuidoost===zuidoost;
altijd===altijd;
willens===willens;
langs===langs;erlangs;
potentieel===potentieel;
nochtans===nochtans;
onbewogen===onbewogen;
vrijwel===vrijwel;
evenzo===evenzo;
bijwijlen===bijwijlen;
althans===althans;
omhoog===omhoog;
qua===qua;
aanzienlijk===aanzienlijk;
zowat===zowat;
jaarlijks===jaarlijks;
bijeen===bijeen;
verbazingwekkend===verbazingwekkend;
rechts===rechts;
amper===amper;
bovenal===bovenal;
traag===traag;
continu===continu;
tesamen===tesamen;
omstreeks===omstreeks;
doordeweek===doordeweek;
rechtens===rechtens;
doorgaans===doorgaans;
gister===gister;
ineen===ineen;
mondjesmaat===mondjesmaat;
precies===precies;
dusverre===dusverre;
formeel===formeel;
toe===toe;
onverwachts===onverwachts;
allang===allang;
erg===erg;
werkelijk===werkelijk;
bijvoorbeeld===bijvoorbeeld;
expres===expres;
tog===tog;
stroomopwaarts===stroomopwaarts;
nulles===nulles;
overwegend===overwegend;
überhaupt===überhaupt;
tussen===tussen;ertussen;
schrijlings===schrijlings;
eindelijk===eindelijk;
laatst===laatst;
voort===voort;
uitgebreid===uitgebreid;
vast===vast;
soms===soms;
onbetwist===onbetwist;
nergens===nergens;
verder===verder;
landwaarts===landwaarts;
blijkens===blijkens;
tegelijkertijd===tegelijkertijd;
symbolisch===symbolisch;
allerminst===allerminst;
hoogstens===hoogstens;
klakkeloos===klakkeloos;
daaro===daaro;
nabij===nabij;
bovenaan===bovenaan;
omgekeerd===omgekeerd;
inmiddels===inmiddels;
blijkbaar===blijkbaar;
grofweg===grofweg;
niet===niet;
nuchter===nuchter;
domweg===domweg;
desondanks===desondanks;
nadelig===nadelig;
acuut===acuut;
alsnog===alsnog;
informeel===informeel;
schuins===schuins;
omlaag===omlaag;
elders===elders;
veruit===veruit;
daarop===daarop;
daarom===daarom;
stapsgewijs===stapsgewijs;
volkomen===volkomen;
onbetaalbaar===onbetaalbaar;
somtijds===somtijds;
normaliter===normaliter;
dagenlang===dagenlang;
tevens===tevens;
noodzakelijkerwijs===noodzakelijkerwijs;
overboord===overboord;
eerlijkheidshalve===eerlijkheidshalve;
scheep===scheep;
gestreng===gestreng;
vergaand===vergaand;
gelijktijdig===gelijktijdig;
sindsdien===sindsdien;
naderhand===naderhand;
nog===nog;
ook===ook;
naast===naast;ernaast;
uiteindelijk===uiteindelijk;
aldra===aldra;
letterlijk===letterlijk;
godse===godse;
uitvoerig===uitvoerig;
fors===fors;
hierheen===hierheen;
almaar===almaar;
intussen===intussen;
weldra===weldra;
spaarzaam===spaarzaam;
voordien===voordien;
tegenwoordig===tegenwoordig;
beslist===beslist;
bewust===bewust;
rigoureus===rigoureus;
der===der;
vermetel===vermetel;
eveneens===eveneens;
uitwaarts===uitwaarts;
rechtstreeks===rechtstreeks;
organisch===organisch;
gewoonlijk===gewoonlijk;
waarlijk===waarlijk;
postuum===postuum;
summier===summier;
desgewenst===desgewenst;
kennelijk===kennelijk;
ergens===ergens;
duidelijk===duidelijk;
overduidelijk===overduidelijk;
aldus===aldus;
schijnbaar===schijnbaar;
tezelfdertijd===tezelfdertijd;
overmorgen===overmorgen;
achtereen===achtereen;
rechtsomkeert===rechtsomkeert;
minstens===minstens;
quasi===quasi;
vroeger===vroeger;
onopzettelijk===onopzettelijk;
mogelijk===mogelijk;
gans===gans;
achterin===achterin;
meestal===meestal;
zuidwaarts===zuidwaarts;
handmatig===handmatig;
daarheen===daarheen;
kortweg===kortweg;
ogenblikkelijk===ogenblikkelijk;
daarentegen===daarentegen;
ironisch===ironisch;
schier===schier;
voortaan===voortaan;
vannacht===vannacht;
hoezo===hoezo;
ruim===ruim;
nimmermeer===nimmermeer;
achterover===achterover;
heemwaarts===heemwaarts;
daartoe===daartoe;
officieel===officieel;
serieus===serieus;
knap===knap;
buitengewoon===buitengewoon;
vermoedelijk===vermoedelijk;
eertijds===eertijds;
gauw===gauw;
wers===wers;
enkel===enkel;
ondertussen===ondertussen;
toentertijd===toentertijd;
standaard===standaard;
uiteraard===uiteraard;
figuurlijk===figuurlijk;
hatelijk===hatelijk;
kostelijk===kostelijk;
eventueel===eventueel;
onderweg===onderweg;
binnendoor===binnendoor;
goed===goed;
uit===uit;
degelijk===degelijk;
even===even;
allereerst===allereerst;
langzamerhand===langzamerhand;
oostwaarts===oostwaarts;
lichtelijk===lichtelijk;
respectievelijk===respectievelijk;
linksaf===linksaf;
west===west;
voorwaar===voorwaar;
afgrijselijk===afgrijselijk;
rechtsom===rechtsom;
vandaan===vandaan;ervandaan;
overhaast===overhaast;
openlijk===openlijk;
stadwaarts===stadwaarts;
aanstonds===aanstonds;
heus===heus;
ze===ze;
vandaag===vandaag;
machtig===machtig;
achterom===achterom;
hiero===hiero;
volledig===volledig;
achterop===achterop;
inderdaad===inderdaad;
tweemaal===tweemaal;
valselijk===valselijk;
zuid===zuid;
naadloos===naadloos;
gewoon===gewoon;
volop===volop;
zo===zo;
ten gevolge===ten gevolge;tengevolge;
vaarwel===vaarwel;
vandaar===vandaar;
perfect===perfect;
volmondig===volmondig;
zelden===zelden;
somwijlen===somwijlen;
wegwaarts===wegwaarts;
drek===drek;
plusminus===plusminus;
evenzeer===evenzeer;
anno===anno;
onder===onder;eronder;
relatief===relatief;
achterna===achterna;
