verongelukken===verongelukken;verongeluk;verongelukke;verongelukt;verongelukte;verongelukten;
mopperen===mopperen;mopper;mopperde;mopperden;moppere;moppert;
uitslaan===uitslaan;uitsla;uitslaat;
voldoen===voldoen;voldeden;voldeed;voldoe;voldoet;
concipiëren===concipiëren;concipieer;concipieerden;concipiëre;
samenzweren===samenzweren;samenzweer;samenzweert;samenzwere;samenzwoer;samenzwoere;samenzwoeren;samenzwoert;
benauwen===benauwen;benauw;benauwde;benauwden;benauwe;benauwt;
afschilderen===afschilderen;afschilder;afschilderde;afschilderden;afschildere;afschildert;
ontmaagden===ontmaagden;ontmaagd;ontmaagdde;ontmaagdden;ontmaagde;ontmaagdt;
zolen===zolen;zole;zoolden;
husselen===husselen;hussel;husselde;husselden;hussele;husselt;
veroorzaken===veroorzaken;veroorzaak;veroorzaakt;veroorzaakte;veroorzaakten;veroorzake;
debatteren===debatteren;debatteer;debatteerde;debatteerden;debatteert;debattere;
thuisbezorgen===thuisbezorgen;thuisbezorg;thuisbezorgde;thuisbezorgden;thuisbezorge;thuisbezorgt;
beseffen===beseffen;beseffe;besefte;beseften;
omgaan===omgaan;omgaat;
uitstappen===uitstappen;uitstap;uitstappe;uitstapt;uitstapte;uitstapten;
inbrengen===inbrengen;inbreng;inbrenge;inbrengt;
struinen===struinen;struin;struinde;struinden;struine;struint;
nestelen===nestelen;nestel;nestelde;nestelden;nestele;nestelt;
wegvallen===wegvallen;wegvalle;wegvielen;
gloeien===gloeien;gloei;gloeide;gloeiden;gloeie;gloeit;
ontregelen===ontregelen;ontregel;ontregelde;ontregelden;ontregele;ontregelt;
omzeilen===omzeilen;omzeil;omzeilde;omzeilden;omzeile;omzeilt;
bijwonen===bijwonen;bijwone;bijwoon;bijwoonden;
schulpen===schulpen;schulp;schulpe;schulpt;schulpte;schulpten;
kronen===kronen;krone;kroonden;
verstrekken===verstrekken;verstrek;verstrekke;verstrekt;verstrekte;verstrekten;
terechtkomen===terechtkomen;terechtkom;terechtkome;terechtkomt;terechtkwame;terechtkwamen;
verzenden===verzenden;verzend;verzende;verzendt;verzonde;verzonden;
terugdringen===terugdringen;terugdring;terugdringe;terugdringt;terugdrong;terugdronge;terugdrongen;terugdrongt;
loeien===loeien;loeiden;loeie;
achten===achten;achte;achtten;
ophogen===ophogen;ophoge;ophoogden;
schellen===schellen;schelde;schelden;schelle;
betegelen===betegelen;betegel;betegelde;betegelden;betegele;betegelt;
echoën===echoën;echoden;echoë;
belichten===belichten;belicht;belichte;belichtte;belichtten;
vernielen===vernielen;verniel;vernielde;vernielden;verniele;vernielt;
hakken===hakken;hakke;hakten;
voortrekken===voortrekken;voortrek;voortrekke;voortrekt;voortrokke;voortrokken;
loeren===loeren;loerden;loere;
voorstaan===voorstaan;voorsta;voorstaat;
tegenspreken===tegenspreken;tegensprak;tegensprake;tegenspraken;tegenspreek;tegenspreekt;tegenspreke;
rechtvaardigen===rechtvaardigen;rechtvaardig;rechtvaardigde;rechtvaardigden;rechtvaardige;rechtvaardigt;
uitleggen===uitleggen;uitlegde;uitlegden;uitlegge;
luiden===luiden;luidden;luide;
manen===manen;maanden;mane;
terugvliegen===terugvliegen;terugvlieg;terugvliege;terugvliegt;terugvloge;terugvlogen;
verontwaardigen===verontwaardigen;verontwaardig;verontwaardigde;verontwaardigden;verontwaardige;verontwaardigt;
bezoldigen===bezoldigen;bezoldig;bezoldigde;bezoldigden;bezoldige;bezoldigt;
weifelen===weifelen;weifel;weifelde;weifelden;weifele;weifelt;
moderniseren===moderniseren;moderniseer;moderniseerde;moderniseerden;moderniseert;modernisere;
beginnen===beginnen;beginne;begonne;begonnen;
verraden===verraden;verraadden;verrade;verrieden;
dwarrelen===dwarrelen;dwarrel;dwarrelde;dwarrelden;dwarrele;dwarrelt;
trotseren===trotseren;trotseer;trotseerde;trotseerden;trotsere;
kleuren===kleuren;kleur;kleurde;kleurden;kleure;kleurt;
beamenen===beamenen;beamen;beamende;beamenden;beamene;beament;
verzetten===verzetten;verzette;
vuren===vuren;vure;vuurden;
dromen===dromen;drome;droomden;
bijten===bijten;bijte;
scharrelen===scharrelen;scharrel;scharrelde;scharrelden;scharrele;scharrelt;
escorteren===escorteren;escorteer;escorteerde;escorteerden;escorteert;escortere;
heugen===heugen;heugden;heuge;
babbelen===babbelen;babbel;babbelde;babbelden;babbele;babbelt;
betreden===betreden;betrade;betraden;betrede;betreed;
zoemen===zoemen;zoemden;zoeme;
bakeren===bakeren;baker;bakerde;bakerden;bakere;bakert;
subsidiëren===subsidiëren;subsidieer;subsidieerden;subsidiëre;
frunniken===frunniken;frunnik;frunnike;frunnikt;frunnikte;frunnikten;
klussen===klussen;klusse;kluste;klusten;
trappen===trappen;trappe;trapte;trapten;
emigreren===emigreren;emigreer;emigreerde;emigreerden;emigrere;
bezwijken===bezwijken;bezweken;bezwijk;bezwijke;bezwijkt;
uitkleden===uitkleden;uitklede;uitkleed;uitkleedde;uitkleedden;
spoelen===spoelen;spoel;spoelde;spoelden;spoele;spoelt;
uitbeelden===uitbeelden;uitbeeld;uitbeeldde;uitbeeldden;uitbeelde;uitbeeldt;
schieten===schieten;schiet;schiete;schoten;
neerleggen===neerleggen;neerleg;neerlegde;neerlegden;neerlegge;neerlegt;
ontwijken===ontwijken;ontweken;ontwijk;ontwijke;ontwijkt;
pleuren===pleuren;
onweren===onweren;onweer;onweerden;onwere;
verweren===verweren;verweer;verweerden;verwere;
schilderen===schilderen;schilder;schilderde;schilderden;schildere;schildert;
verzachten===verzachten;verzacht;verzachte;verzachtte;verzachtten;
melken===melken;melke;molken;
beletten===beletten;belette;
omwikkelen===omwikkelen;omwikkel;omwikkelde;omwikkelden;omwikkele;omwikkelt;
rammen===rammen;ramden;ramme;
interageren===interageren;interageer;interageerde;interageerden;interageert;interagere;
kanten===kanten;kante;kantten;
duuren===duuren;
inleveren===inleveren;inlever;inleverde;inleverden;inlevere;inlevert;
associëren===associëren;associeer;associeerden;associëre;
bijspijkeren===bijspijkeren;bijspijker;bijspijkerde;bijspijkerden;bijspijkere;bijspijkert;
planten===planten;plant;plante;plantte;plantten;
verstoppen===verstoppen;verstop;verstoppe;verstopt;verstopte;verstopten;
stuwen===stuwen;stuwden;stuwe;
omtoveren===omtoveren;omtover;omtoverde;omtoverden;omtovere;omtovert;
verblijden===verblijden;verblijd;verblijdde;verblijdden;verblijde;verblijdt;
kreukelen===kreukelen;kreukel;kreukelde;kreukelden;kreukele;kreukelt;
losmaken===losmaken;losmaakten;losmake;
zeilen===zeilen;zeilden;zeile;
bakken===bakken;bakke;bakten;
finishen===finishen;finish;finishe;finisht;finishte;finishten;
upgraden===upgraden;upgrade;upgradede;upgradeden;upgradet;
oliën===oliën;olië;
opknappen===opknappen;opknappe;opknapte;opknapten;
declareren===declareren;declareer;declareerde;declareerden;declareert;declarere;
veren===veren;veerden;vere;
giechelen===giechelen;giechel;giechelde;giechelden;giechele;giechelt;
kreunen===kreunen;kreun;kreunde;kreunden;kreune;kreunt;
slenteren===slenteren;slenter;slenterde;slenterden;slentere;slentert;
gebeuren===gebeuren;gebeur;gebeurde;gebeurden;gebeure;gebeurt;
compromitteren===compromitteren;compromitteer;compromitteerde;compromitteerden;compromitteert;compromittere;
schitteren===schitteren;schitter;schitterde;schitterden;schittere;schittert;
diagnosticeren===diagnosticeren;diagnosticeer;diagnosticeerde;diagnosticeerden;diagnosticeert;diagnosticere;
verzuipen===verzuipen;verzopen;verzuip;verzuipe;verzuipt;
splijten===splijten;spleten;splijt;splijte;
overgeven===overgeven;overgave;overgaven;overgeef;overgeve;
herkrijgen===herkrijgen;herkrege;herkregen;herkrijg;herkrijge;herkrijgt;
uitbaten===uitbaten;uitbaatten;uitbate;
vingeren===vingeren;vinger;vingerde;vingerden;vingere;vingert;
hallucineren===hallucineren;
vreten===vreten;vraten;vrete;
rapporteren===rapporteren;rapporteer;rapporteerde;rapporteerden;rapporteert;rapportere;
welvaren===welvaren;welvaarden;welvare;
knipperen===knipperen;knipper;knipperde;knipperden;knippere;knippert;
instorten===instorten;instort;instorte;instortte;instortten;
vergen===vergen;vergden;verge;
horen===horen;hoorden;hore;
stappen===stappen;stappe;stapte;stapten;
aanmeren===aanmeren;aanmeer;aanmeerden;aanmere;
stuiteren===stuiteren;stuiter;stuiterde;stuiterden;stuitere;stuitert;
verstenen===verstenen;versteen;versteende;versteenden;versteent;verstene;
flaneren===flaneren;flaneer;flaneerden;flanere;
roteren===roteren;roteer;roteerden;rotere;
regisseren===regisseren;regisseer;regisseerde;regisseerden;regisseert;regissere;
lonen===lonen;lone;loonden;
wijzigen===wijzigen;wijzig;wijzigde;wijzigden;wijzige;wijzigt;
browsen===browsen;browse;browsede;browseden;browset;
vergisten===vergisten;vergist;vergiste;vergistte;vergistten;
kapen===kapen;kaapten;kape;
omkopen===omkopen;omkope;
eindigen===eindigen;eindig;eindigde;eindigden;eindige;eindigt;
herinneren===herinneren;herinner;herinnerde;herinnerden;herinnere;herinnert;
interesseren===interesseren;interesseer;interesseerde;interesseerden;interesseert;interessere;
beperken===beperken;beperk;beperke;beperkt;beperkte;beperkten;
belonen===belonen;belone;beloon;beloonden;
pleiten===pleiten;pleit;pleite;pleitte;pleitten;
fouilleren===fouilleren;fouilleer;fouilleerde;fouilleerden;fouilleert;fouillere;
sponsoren===sponsoren;sponsor;sponsorde;sponsorden;sponsore;sponsort;
inspireren===inspireren;inspireer;inspireerde;inspireerden;inspireert;inspirere;
incasseren===incasseren;incasseer;incasseerde;incasseerden;incasseert;incassere;
implementeren===implementeren;implementeer;implementeerde;implementeerden;implementeert;implementere;
gappen===gappen;gappe;gapten;
verhelpen===verhelpen;verhelp;verhelpe;verhelpt;verhielpe;verhielpen;
lammeren===lammeren;lammer;lammerde;lammerden;lammere;lammert;
glazen===glazen;glaze;
naken===naken;naakten;nake;
uitreiken===uitreiken;uitreik;uitreike;uitreikt;uitreikte;uitreikten;
bedaren===bedaren;bedaarden;bedare;
verhongeren===verhongeren;verhonger;verhongerde;verhongerden;verhongere;verhongert;
samenstellen===samenstellen;samenstel;samenstelde;samenstelden;samenstelle;samenstelt;
fuseren===fuseren;fuseer;fuseerden;fusere;
boegseren===boegseren;boegseer;boegseerde;boegseerden;boegsere;
uitblazen===uitblazen;uitblaze;uitbliezen;
ontlopen===ontlopen;ontliepen;ontlope;
verrukken===verrukken;verrukke;verrukte;verrukten;
doden===doden;dode;doodden;
oordelen===oordelen;oordeel;oordeelden;oordele;
tegenvallen===tegenvallen;tegenval;tegenvalle;tegenvalt;tegenviele;tegenvielen;
confronteren===confronteren;confronteer;confronteerde;confronteerden;confronteert;confrontere;
hinniken===hinniken;hinnik;hinnike;hinnikt;hinnikte;hinnikten;
aanzwellen===aanzwellen;aanzwel;aanzwelle;aanzwelt;aanzwolle;aanzwollen;
afgaan===afgaan;afgaat;
kluppelen===kluppelen;kluppel;kluppelde;kluppelden;kluppele;kluppelt;
verplanten===verplanten;verplant;verplante;verplantte;verplantten;
kauwen===kauwen;kauwden;kauwe;
snoezelen===snoezelen;snoezel;snoezelde;snoezelden;snoezele;snoezelt;
overleven===overleven;overleef;overleefden;overleve;
verbeteren===verbeteren;verbeter;verbeterde;verbeterden;verbetere;verbetert;
verbleken===verbleken;verbleek;verbleekte;verbleekten;verbleke;
ontketenen===ontketenen;ontketen;ontketende;ontketenden;ontketene;ontketent;
beeldhouwen===beeldhouwen;beeldhouw;beeldhouwde;beeldhouwden;beeldhouwe;beeldhouwt;
overleveren===overleveren;overlever;overleverde;overleverden;overlevere;overlevert;
aanvallen===aanvallen;aanvalle;aanvielen;
vereenvoudigen===vereenvoudigen;vereenvoudig;vereenvoudigde;vereenvoudigden;vereenvoudige;vereenvoudigt;
adoreren===adoreren;adoreer;adoreerden;adorere;
schrijden===schrijden;schreden;schrijd;schrijde;schrijdt;
vernederen===vernederen;verneder;vernederde;vernederden;vernedere;vernedert;
vormen===vormen;vormden;vorme;
afslaan===afslaan;afsla;afslaat;
dammen===dammen;damden;damme;
frustreren===frustreren;frustreer;frustreerde;frustreerden;frustreert;frustrere;
signaleren===signaleren;signaleer;signaleerde;signaleerden;signaleert;signalere;
doorbladeren===doorbladeren;doorblader;doorbladerde;doorbladerden;doorbladere;doorbladert;
inburgeren===inburgeren;inburger;inburgerde;inburgerden;inburgere;inburgert;
vermoorden===vermoorden;vermoord;vermoordde;vermoordden;vermoorde;vermoordt;
toegeven===toegeven;toegave;toegaven;toegeef;toegeve;
betrachten===betrachten;betracht;betrachte;betrachtte;betrachtten;
neuken===neuken;neuke;neukten;
uitlezen===uitlezen;uitlaze;uitlazen;uitlees;uitleze;
uitschrijven===uitschrijven;uitschreve;uitschreven;uitschrijf;uitschrijft;uitschrijve;
misprijzen===misprijzen;mispreze;misprezen;misprijs;misprijst;misprijze;
hangen===hangen;hange;hingen;
comazuipen===comazuipen;
amputeren===amputeren;amputeer;amputeerde;amputeerden;amputere;
gutsen===gutsen;gutse;gutsten;
doorsturen===doorsturen;doorsture;doorstuur;doorstuurde;doorstuurden;doorstuurt;
stapelen===stapelen;stapel;stapelde;stapelden;stapele;stapelt;
puberen===puberen;puber;puberde;puberden;pubere;pubert;
pappen===pappen;pappe;papten;
kroelen===kroelen;kroel;kroelde;kroelden;kroele;kroelt;
verdrinken===verdrinken;verdrink;verdrinke;verdrinkt;verdronk;verdronke;verdronken;verdronkt;
mailen===mailen;mailden;maile;
schuwen===schuwen;schuw;schuwde;schuwden;schuwe;schuwt;
barsten===barsten;barst;barste;barstte;barstten;bersten;borsten;
uitrollen===uitrollen;uitrolde;uitrolden;uitrolle;
terugkomen===terugkomen;terugkom;terugkome;terugkomt;terugkwame;terugkwamen;
verharen===verharen;verhaarden;verhare;
potten===potten;potte;
provoceren===provoceren;provoceer;provoceerde;provoceerden;provoceert;provocere;
voorschrijven===voorschrijven;voorschreve;voorschreven;voorschrijf;voorschrijft;voorschrijve;
analyseren===analyseren;analyseer;analyseerde;analyseerden;analyseert;analysere;
informeren===informeren;informeer;informeerde;informeerden;informeert;informere;
berokkenen===berokkenen;berokken;berokkende;berokkenden;berokkene;berokkent;
ontsieren===ontsieren;ontsier;ontsierde;ontsierden;ontsiere;ontsiert;
vergrendelen===vergrendelen;vergrendel;vergrendelde;vergrendelden;vergrendele;vergrendelt;
rokeren===rokeren;rokeer;rokeerden;rokere;
weglaten===weglaten;weglate;weglieten;
ontwikkelen===ontwikkelen;ontwikkel;ontwikkelde;ontwikkelden;ontwikkele;ontwikkelt;
verdrukken===verdrukken;verdruk;verdrukke;verdrukt;verdrukte;verdrukten;
ontworstelen===ontworstelen;ontworstel;ontworstelde;ontworstelden;ontworstele;ontworstelt;
terugkrijgen===terugkrijgen;terugkrege;terugkregen;terugkrijg;terugkrijge;terugkrijgt;
vereeuwigen===vereeuwigen;vereeuwig;vereeuwigde;vereeuwigden;vereeuwige;vereeuwigt;
zegenen===zegenen;zegen;zegende;zegenden;zegene;zegent;
uitblinken===uitblinken;uitblink;uitblinke;uitblinkt;uitblonk;uitblonke;uitblonken;uitblonkt;
omklemmen===omklemmen;omklemde;omklemden;omklemme;
opleven===opleven;opleef;opleve;
voorbehouden===voorbehouden;voorbehielden;voorbehou;voorbehoud;voorbehoude;voorbehoudt;
onthalen===onthalen;onthaalden;onthale;
afwerpen===afwerpen;afwerp;afwerpe;afwerpt;afwierpe;afwierpen;
verlagen===verlagen;verlaagden;verlage;
funderen===funderen;fundeer;fundeerden;fundere;
geuren===geuren;geurden;geure;
afsteken===afsteken;afstake;afstaken;afsteek;afsteke;
meesmuilen===meesmuilen;meesmuil;meesmuilde;meesmuilden;meesmuile;meesmuilt;
aandringen===aandringen;aandring;aandringe;aandringt;aandrong;aandronge;aandrongen;aandrongt;
notuleren===notuleren;notuleer;notuleerde;notuleerden;notulere;
gebaren===gebaren;gebaarden;gebare;
voorhangen===voorhangen;voorhang;voorhange;voorhangt;voorhing;voorhinge;voorhingen;voorhingt;
abdiceren===abdiceren;abdiceer;abdiceerde;abdiceerden;abdicere;
prijsgeven===prijsgeven;
wisselen===wisselen;wissel;wisselde;wisselden;wissele;wisselt;
downloaden===downloaden;download;downloadde;downloadden;downloade;downloadt;
goedkeuren===goedkeuren;goedkeur;goedkeurde;goedkeurden;goedkeure;goedkeurt;
voortborduren===voortborduren;voortbordure;voortborduur;voortborduurde;voortborduurden;voortborduurt;
feesten===feesten;feest;feeste;feestte;feestten;
printen===printen;print;printe;printte;printten;
jachten===jachten;jacht;jachte;jachtte;jachtten;
gekscheren===gekscheren;gekscheer;gekscheerde;gekscheerden;gekscheert;gekschere;
schenden===schenden;schend;schende;schendt;schonde;schonden;
centrifugeren===centrifugeren;centrifugeer;centrifugeerde;centrifugeerden;centrifugeert;centrifugere;
urineren===urineren;urineer;urineerden;urinere;
knetteren===knetteren;knetter;knetterde;knetterden;knettere;knettert;
druipen===druipen;dropen;druip;druipe;druipt;
spioneren===spioneren;spioneer;spioneerde;spioneerden;spionere;
breien===breien;breiden;breie;
afpakken===afpakken;afpakke;afpakte;afpakten;
kolken===kolken;kolke;kolkten;
benodigen===benodigen;benodig;benodigde;benodigden;benodige;benodigt;
verlichten===verlichten;verlicht;verlichte;verlichtte;verlichtten;
wenken===wenken;wenke;wenkten;
polijsten===polijsten;polijst;polijste;polijstte;polijstten;
synchroniseren===synchroniseren;synchroniseer;synchroniseerde;synchroniseerden;synchroniseert;synchronisere;
deren===deren;deerden;dere;
vriezen===vriezen;vrieze;
optrommelen===optrommelen;optrommel;optrommelde;optrommelden;optrommele;optrommelt;
passeren===passeren;passeer;passeerden;passere;
handelen===handelen;handel;handelde;handelden;handele;handelt;
schransen===schransen;schrans;schranse;schranst;schranste;schransten;
ingrijpen===ingrijpen;ingrepen;ingrijp;ingrijpe;ingrijpt;
verbreken===verbreken;verbrake;verbraken;verbreek;verbreke;
toewijden===toewijden;toewijd;toewijdde;toewijdden;toewijde;toewijdt;
overwegen===overwegen;overweeg;overwege;overwoge;overwogen;
slabakken===slabakken;slabakke;slabakte;slabakten;
toekeren===toekeren;toekeer;toekeerden;toekere;
aanpassen===aanpassen;aanpasse;aanpaste;aanpasten;
verkloten===verkloten;verklootte;verklootten;verklote;
verzoeken===verzoeken;verzochten;verzoek;verzoeke;verzoekt;
intrekken===intrekken;intrekke;introkke;introkken;
beknibbelen===beknibbelen;beknibbel;beknibbelde;beknibbelden;beknibbele;beknibbelt;
demotiveren===demotiveren;demotiveer;demotiveerde;demotiveerden;demotiveert;demotivere;
sluipen===sluipen;slopen;sluip;sluipe;sluipt;
voorlezen===voorlezen;voorlaze;voorlazen;voorlees;voorleze;
aanlengen===aanlengen;aanleng;aanlengde;aanlengden;aanlenge;aanlengt;
rubriceren===rubriceren;rubriceer;rubriceerde;rubriceerden;rubriceert;rubricere;
omslaan===omslaan;omsla;omslaat;
vergrijpen===vergrijpen;vergrepe;vergrepen;vergrijp;vergrijpe;vergrijpt;
zegevieren===zegevieren;zegevier;zegevierde;zegevierden;zegeviere;zegeviert;
opschorten===opschorten;opschort;opschorte;opschortte;opschortten;
uitwaaieren===uitwaaieren;uitwaaier;uitwaaierde;uitwaaierden;uitwaaiere;uitwaaiert;
laken===laken;laakten;lake;
gniffelen===gniffelen;gniffel;gniffelde;gniffelden;gniffele;gniffelt;
treden===treden;traden;trede;
converseren===converseren;converseer;converseerde;converseerden;converseert;conversere;
terugbellen===terugbellen;terugbel;terugbelde;terugbelden;terugbelle;terugbelt;
vergemakkelijken===vergemakkelijken;vergemakkelijk;vergemakkelijke;vergemakkelijkt;vergemakkelijkte;vergemakkelijkten;
afstraffen===afstraffen;afstraf;afstraffe;afstraft;afstrafte;afstraften;
afkalven===afkalven;afkalfden;afkalve;
verkneukelen===verkneukelen;verkneukel;verkneukelde;verkneukelden;verkneukele;verkneukelt;
oversteken===oversteken;overstak;overstake;overstaken;oversteek;oversteekt;oversteke;
inlijven===inlijven;inlijfden;inlijve;
sparen===sparen;spaarden;spare;
verkiezen===verkiezen;verkieze;verkozen;
opsporen===opsporen;opspoorden;opspore;
afkussen===afkussen;afkusse;afkuste;afkusten;
resulteren===resulteren;resulteer;resulteerde;resulteerden;resulteert;resultere;
duimen===duimen;duimden;duime;
nijgen===nijgen;nijge;
helpen===helpen;helpe;hielpen;
huilebalken===huilebalken;huilebalk;huilebalke;huilebalkt;huilebalkte;huilebalkten;
bijvoegen===bijvoegen;bijvoeg;bijvoegde;bijvoegden;bijvoege;bijvoegt;
wensen===wensen;wense;wensten;
verergeren===verergeren;vererger;verergerde;verergerden;verergere;verergert;
voortgaan===voortgaan;voortga;voortgaat;
erven===erven;erve;
streven===streven;streef;streve;
krijsen===krijsen;kresen;krijs;krijse;krijst;
sluimeren===sluimeren;sluimer;sluimerde;sluimerden;sluimere;sluimert;
weven===weven;weve;
doorsnijden===doorsnijden;doorsnede;doorsneden;doorsnij;doorsnijd;doorsnijde;doorsnijdt;
arriveren===arriveren;arriveer;arriveerde;arriveerden;arrivere;
meemaken===meemaken;meemaakten;meemake;
smikkelen===smikkelen;smikkel;smikkelde;smikkelden;smikkele;smikkelt;
verjagen===verjagen;verjaagden;verjage;verjoegen;
verstoren===verstoren;verstoorde;verstoorden;verstore;
ruilen===ruilen;ruilden;ruile;
ommuren===ommuren;ommure;ommuurden;
dreunen===dreunen;dreun;dreunde;dreunden;dreune;dreunt;
traliën===traliën;tralie;traliet;tralië;
knikken===knikken;knikke;knikte;knikten;
rondhangen===rondhangen;rondhang;rondhange;rondhangt;rondhing;rondhinge;rondhingen;rondhingt;
vloeien===vloeien;vloei;vloeide;vloeiden;vloeie;vloeit;
meevallen===meevallen;meevalle;meevielen;
onderhouden===onderhouden;onderhielden;onderhou;onderhoud;onderhoude;onderhoudt;
dweilen===dweilen;dweil;dweilde;dweilden;dweile;dweilt;
hernieuwen===hernieuwen;hernieuw;hernieuwde;hernieuwden;hernieuwe;hernieuwt;
communiceren===communiceren;communiceer;communiceerde;communiceerden;communiceert;communicere;
keren===keren;keerden;kere;
woelen===woelen;woelden;woele;
klaverjassen===klaverjassen;klaverjas;klaverjasse;klaverjast;klaverjaste;klaverjasten;
kietelen===kietelen;kietel;kietelde;kietelden;kietele;kietelt;
opperen===opperen;opper;opperde;opperden;oppere;oppert;
bekwamen===bekwamen;bekwaamden;bekwame;
besmeren===besmeren;besmeer;besmeerden;besmere;
losstaan===losstaan;lossta;losstaat;
aanklagen===aanklagen;aanklaagde;aanklaagden;aanklage;
herenigen===herenigen;herenig;herenigde;herenigden;herenige;herenigt;
oproepen===oproepen;opriepe;opriepen;oproep;oproepe;oproept;
schakelen===schakelen;schakel;schakelde;schakelden;schakele;schakelt;
wijken===wijken;wijke;
drijten===drijten;dreten;drijt;drijte;
haken===haken;haakten;hake;
kitten===kitten;
fêteren===fêteren;fêteer;fêteerden;fêtere;
afzien===afzien;afzagen;afzie;afziet;
grootbrengen===grootbrengen;grootbreng;grootbrenge;grootbrengt;
verrijzen===verrijzen;verrezen;verrijze;
stichten===stichten;sticht;stichte;stichtte;stichtten;
inzagen===inzagen;
gespen===gespen;gespe;gespten;
uitspreken===uitspreken;uitsprak;uitsprake;uitspraken;uitspreek;uitspreekt;uitspreke;
zoenen===zoenen;zoenden;zoene;
opsluiten===opsluiten;opsloten;opsluit;opsluite;
tuchtigen===tuchtigen;tuchtig;tuchtigde;tuchtigden;tuchtige;tuchtigt;
omvormen===omvormen;omvorm;omvormde;omvormden;omvorme;omvormt;
gehoorzamen===gehoorzamen;gehoorzaam;gehoorzaamde;gehoorzaamden;gehoorzaamt;gehoorzame;
opsturen===opsturen;opsture;opstuurden;
knallen===knallen;knalde;knalden;knalle;
dekken===dekken;dekke;dekten;
verdoen===verdoen;verdeden;verdeed;verdoe;verdoet;
snijden===snijden;sneden;snijd;snijde;snijdt;
exploiteren===exploiteren;exploiteer;exploiteerde;exploiteerden;exploiteert;exploitere;
groeten===groeten;groet;groete;groette;groetten;
afstempelen===afstempelen;afstempel;afstempelde;afstempelden;afstempele;afstempelt;
derogeren===derogeren;derogeer;derogeerde;derogeerden;derogere;
beëdigen===beëdigen;beëdig;beëdigde;beëdigden;beëdige;beëdigt;
schermen===schermen;scherm;schermde;schermden;scherme;schermt;
neerploffen===neerploffen;neerplof;neerploffe;neerploft;neerplofte;neerploften;
lunchen===lunchen;lunch;lunche;luncht;lunchte;lunchten;
geleiden===geleiden;geleid;geleidde;geleidden;geleide;geleidt;
borduren===borduren;bordure;borduurden;
verzouten===verzouten;verzout;verzoute;verzoutte;verzoutten;
misbruiken===misbruiken;misbruik;misbruike;misbruikt;misbruikte;misbruikten;
koppen===koppen;koppe;kopten;
promoveren===promoveren;promoveer;promoveerde;promoveerden;promoveert;promovere;
leeglopen===leeglopen;leegliepen;leeglope;
bieden===bieden;biede;
wrijven===wrijven;wreven;wrijve;
wegvoeren===wegvoeren;wegvoer;wegvoerde;wegvoerden;wegvoere;wegvoert;
voltrekken===voltrekken;voltrek;voltrekke;voltrekt;voltrokke;voltrokken;
voelen===voelen;voelden;voele;
intomen===intomen;intome;intoomden;
wegebben===wegebben;wegebbe;wegebde;wegebden;
kruien===kruien;kruiden;kruie;
ondermijnen===ondermijnen;ondermijn;ondermijnde;ondermijnden;ondermijne;ondermijnt;
innemen===innemen;inname;innamen;inneem;inneme;
uitleveren===uitleveren;uitlever;uitleverde;uitleverden;uitlevere;uitlevert;
kapseizen===kapseizen;kapseisden;kapseize;
janken===janken;janke;jankten;
betwijfelen===betwijfelen;betwijfel;betwijfelde;betwijfelden;betwijfele;betwijfelt;
wijten===wijten;wijte;
aftappen===aftappen;
bezuinigen===bezuinigen;bezuinig;bezuinigde;bezuinigden;bezuinige;bezuinigt;
verwijven===verwijven;verwijfden;verwijve;
verdoemen===verdoemen;verdoem;verdoemde;verdoemden;verdoeme;verdoemt;
sjansen===sjansen;sjans;sjanse;sjanst;sjanste;sjansten;
opslaan===opslaan;opsla;opslaat;
peuzelen===peuzelen;peuzel;peuzelde;peuzelden;peuzele;peuzelt;
kiezen===kiezen;kieze;
bekogelen===bekogelen;bekogel;bekogelde;bekogelden;bekogele;bekogelt;
knuppelen===knuppelen;knuppel;knuppelde;knuppelden;knuppele;knuppelt;
adstrueren===adstrueren;adstrueer;adstrueerde;adstrueerden;adstrueert;adstruere;
afzinken===afzinken;afzink;afzinke;afzinkt;afzonke;afzonken;
gelden===gelden;gelde;golden;
broeden===broeden;broed;broedde;broedden;broede;broedt;
belanden===belanden;beland;belandde;belandden;belande;belandt;
onderwijzen===onderwijzen;onderweze;onderwezen;onderwijs;onderwijst;onderwijze;
transplanteren===transplanteren;transplanteer;transplanteerde;transplanteerden;transplanteert;transplantere;
sperren===sperren;sperde;sperden;sperre;
bewegen===bewegen;beweeg;bewege;bewoge;bewogen;
baten===baten;baatten;bate;
afrekenen===afrekenen;
hypnotiseren===hypnotiseren;hypnotiseer;hypnotiseerde;hypnotiseerden;hypnotiseert;hypnotisere;
uiteenlopen===uiteenlopen;uiteenliep;uiteenliepe;uiteenliepen;uiteenloop;uiteenloopt;uiteenlope;
afschieten===afschieten;afschiet;afschiete;afschote;afschoten;
afspoelen===afspoelen;afspoel;afspoelde;afspoelden;afspoele;afspoelt;
knabbelen===knabbelen;knabbel;knabbelde;knabbelden;knabbele;knabbelt;
aanstellen===aanstellen;aanstel;aanstelde;aanstelden;aanstelle;aanstelt;
lessen===lessen;lesse;lesten;
bederven===bederven;bederve;bedierven;bedorve;bedorven;
huizen===huizen;huisden;huize;
knipogen===knipogen;knipoge;knipoogden;
coderen===coderen;codeer;codeerden;codere;
neersteken===neersteken;neerstak;neerstake;neerstaken;neersteek;neersteekt;neersteke;
verloederen===verloederen;verloeder;verloederde;verloederden;verloedere;verloedert;
zomen===zomen;zome;zoomden;
ontsluiten===ontsluiten;ontslote;ontsloten;ontsluit;ontsluite;
ontcijferen===ontcijferen;ontcijfer;ontcijferde;ontcijferden;ontcijfere;ontcijfert;
flitsen===flitsen;flits;flitse;flitst;flitste;flitsten;
schaken===schaken;schaakten;schake;
najagen===najagen;najaagden;najage;najoegen;
bezwaren===bezwaren;bezwaarden;bezware;
gluren===gluren;glure;gluurden;
aanreiken===aanreiken;aanreik;aanreike;aanreikt;aanreikte;aanreikten;
voortbrengen===voortbrengen;voortbreng;voortbrenge;voortbrengt;
doorzetten===doorzetten;doorzet;doorzette;
ritten===ritten;ritte;
coïncideren===coïncideren;coïncideer;coïncideerde;coïncideerden;coïncideert;coïncidere;
vissen===vissen;visse;visten;
verlokken===verlokken;verlokke;verlokte;verlokten;
grissen===grissen;grisse;griste;gristen;
mijden===mijden;mijde;
riskeren===riskeren;riskeer;riskeerden;riskere;
aanzetten===aanzetten;aanzette;
klateren===klateren;
ruïneren===ruïneren;ruïneer;ruïneerden;ruïnere;
importeren===importeren;importeer;importeerde;importeerden;importeert;importere;
ontvangen===ontvangen;ontvang;ontvange;ontvangt;ontvinge;ontvingen;
glunderen===glunderen;glunder;glunderde;glunderden;glundere;glundert;
vonken===vonken;vonke;vonkten;
opeisen===opeisen;opeis;opeise;opeist;opeiste;opeisten;
laaien===laaien;laaiden;laaie;
uitzonderen===uitzonderen;uitzonder;uitzonderde;uitzonderden;uitzondere;uitzondert;
scharen===scharen;schaarden;schare;
overzien===overzien;overzagen;overzie;overziet;
skeeleren===skeeleren;skeeler;skeelerde;skeelerden;skeelere;skeelert;
stormen===stormen;storm;stormde;stormden;storme;stormt;
galmen===galmen;galmden;galme;
bulderen===bulderen;bulder;bulderde;bulderden;buldere;buldert;
ontbinden===ontbinden;ontbind;ontbinde;ontbindt;ontbonde;ontbonden;
groeven===groeven;groefden;groeve;
overnemen===overnemen;overname;overnamen;overneem;overneme;
verscheuren===verscheuren;verscheur;verscheurde;verscheurden;verscheure;verscheurt;
voorzetten===voorzetten;voorzet;voorzette;
verwisselen===verwisselen;verwissel;verwisselde;verwisselden;verwissele;verwisselt;
overstijgen===overstijgen;overstege;overstegen;overstijg;overstijge;overstijgt;
verkennen===verkennen;verkende;verkenden;verkenne;
aandoen===aandoen;aandeden;aandeed;aandoe;aandoet;
uitwisselen===uitwisselen;uitwissel;uitwisselde;uitwisselden;uitwissele;uitwisselt;
knappen===knappen;knappe;knapte;knapten;
samenwerken===samenwerken;samenwerk;samenwerke;samenwerkt;samenwerkte;samenwerkten;
metselen===metselen;metsel;metselde;metselden;metsele;metselt;
plompzakken===plompzakken;plompzak;plompzakke;plompzakt;plompzakte;plompzakten;
bijtanken===bijtanken;bijtank;bijtanke;bijtankt;bijtankte;bijtankten;
toevoegen===toevoegen;toevoeg;toevoegde;toevoegden;toevoege;toevoegt;
dalen===dalen;daalden;dale;
annuleren===annuleren;annuleer;annuleerde;annuleerden;annulere;
pakken===pakken;pakke;pakten;
plassen===plassen;plasse;plaste;plasten;
bepraten===bepraten;bepraatten;beprate;
tegemoetkomen===tegemoetkomen;tegemoetkom;tegemoetkome;tegemoetkomt;tegemoetkwame;tegemoetkwamen;
hervatten===hervatten;hervatte;
herbergen===herbergen;herberg;herbergde;herbergden;herberge;herbergt;
arceren===arceren;arceer;arceerden;arcere;
opkrikken===opkrikken;opkrikke;opkrikte;opkrikten;
verwezenlijken===verwezenlijken;verwezenlijk;verwezenlijke;verwezenlijkt;verwezenlijkte;verwezenlijkten;
lengen===lengen;
testritten===testritten;testrit;testritte;
verroeren===verroeren;verroer;verroerde;verroerden;verroere;verroert;
drenken===drenken;drenk;drenke;drenkt;drenkte;drenkten;
blootstellen===blootstellen;blootstel;blootstelde;blootstelden;blootstelle;blootstelt;
accepteren===accepteren;accepteer;accepteerde;accepteerden;accepteert;acceptere;
moppen===moppen;moppe;mopten;
uitbesteden===uitbesteden;uitbestede;uitbesteed;uitbesteedde;uitbesteedden;uitbesteedt;
zwelten===zwelten;
galopperen===galopperen;galoppeer;galoppeerde;galoppeerden;galoppeert;galoppere;
naaien===naaien;naaiden;naaie;
aanbreken===aanbreken;aanbrake;aanbraken;aanbreek;aanbreke;
rijden===rijden;rijde;
ondergaan===ondergaan;onderga;ondergaat;
beslaan===beslaan;besla;beslaat;
wegdoen===wegdoen;wegdeden;wegdeed;wegdoe;wegdoet;
uithalen===uithalen;uithaalden;uithale;
bestelen===bestelen;bestale;bestalen;besteel;bestele;
binnentrekken===binnentrekken;binnentrek;binnentrekke;binnentrekt;binnentrokke;binnentrokken;
herstellen===herstellen;herstel;herstelde;herstelden;herstelle;herstelt;
uitblijven===uitblijven;uitbleve;uitbleven;uitblijf;uitblijft;uitblijve;
zeiken===zeiken;zeike;zeikten;zeken;
dringen===dringen;dring;dringe;dringt;dronge;drongen;
opstijgen===opstijgen;opstegen;opstijg;opstijge;opstijgt;
opvullen===opvullen;opvulde;opvulden;opvulle;
afhangen===afhangen;afhang;afhange;afhangt;afhinge;afhingen;
besluipen===besluipen;beslopen;besluip;besluipe;besluipt;
maximaliseren===maximaliseren;maximaliseer;maximaliseerde;maximaliseerden;maximaliseert;maximalisere;
uithuwelijken===uithuwelijken;uithuwelijk;uithuwelijke;uithuwelijkt;uithuwelijkte;uithuwelijkten;
keuvelen===keuvelen;keuvel;keuvelde;keuvelden;keuvele;keuvelt;
vlieten===vlieten;vliet;vliete;vloten;
afklemmen===afklemmen;afklemde;afklemden;afklemme;
snoeien===snoeien;snoei;snoeide;snoeiden;snoeie;snoeit;
verdoezelen===verdoezelen;verdoezel;verdoezelde;verdoezelden;verdoezele;verdoezelt;
landen===landen;landden;lande;
gapen===gapen;gaapten;gape;
bekrachtigen===bekrachtigen;bekrachtig;bekrachtigde;bekrachtigden;bekrachtige;bekrachtigt;
beschilderen===beschilderen;beschilder;beschilderde;beschilderden;beschildere;beschildert;
interpreteren===interpreteren;interpreteer;interpreteerde;interpreteerden;interpreteert;interpretere;
weggeven===weggeven;weggave;weggaven;weggeef;weggeve;
zwaaien===zwaaien;zwaai;zwaaide;zwaaiden;zwaaie;zwaait;
ophelderen===ophelderen;ophelder;ophelderde;ophelderden;opheldere;opheldert;
uithouden===uithouden;uithielden;uithoud;uithoude;uithoudt;
kissebissen===kissebissen;kissebis;kissebisse;kissebist;kissebiste;kissebisten;
oppassen===oppassen;oppasse;oppaste;oppasten;
proletariseren===proletariseren;proletariseer;proletariseerde;proletariseerden;proletariseert;proletarisere;
verslinden===verslinden;verslind;verslinde;verslindt;verslond;verslonde;verslonden;verslondt;
slokken===slokken;slokke;slokte;slokten;
bonzen===bonzen;bonsden;bonze;
bleken===bleken;bleekten;bleke;
aantreffen===aantreffen;aantref;aantreffe;aantreft;aantroffe;aantroffen;
verflensen===verflensen;verflens;verflense;verflenst;verflenste;verflensten;
herleiden===herleiden;herleid;herleidde;herleidden;herleide;herleidt;
idealiseren===idealiseren;idealiseer;idealiseerde;idealiseerden;idealiseert;idealisere;
afzonderen===afzonderen;afzonder;afzonderde;afzonderden;afzondere;afzondert;
fungeren===fungeren;fungeer;fungeerden;fungere;
uitroeien===uitroeien;uitroei;uitroeide;uitroeiden;uitroeie;uitroeit;
binnenhalen===binnenhalen;binnenhaal;binnenhaalde;binnenhaalden;binnenhaalt;binnenhale;
aanblijven===aanblijven;aanbleve;aanbleven;aanblijf;aanblijfen;aanblijft;aanblijve;
lassen===lassen;lasse;lasten;
bezaaien===bezaaien;bezaai;bezaaide;bezaaiden;bezaaie;bezaait;
verduidelijken===verduidelijken;verduidelijk;verduidelijke;verduidelijkt;verduidelijkte;verduidelijkten;
interrumperen===interrumperen;interrumpeer;interrumpeerde;interrumpeerden;interrumpeert;interrumpere;
kalibreren===kalibreren;kalibreer;kalibreerde;kalibreerden;kalibreert;kalibrere;
betalen===betalen;betaalden;betale;
duwen===duwen;douwen;duwden;duwe;
lobben===lobben;lobbe;lobden;
zwichten===zwichten;zwicht;zwichte;zwichtte;zwichtten;
zijgen===zijgen;zijge;
opvatten===opvatten;opvatte;
verhuren===verhuren;verhure;verhuurden;
weerkaatsen===weerkaatsen;weerkaats;weerkaatse;weerkaatst;weerkaatste;weerkaatsten;
beschimmelen===beschimmelen;beschimmel;beschimmelde;beschimmelden;beschimmele;beschimmelt;
strekken===strekken;strekke;strekte;strekten;
opschrikken===opschrikken;opschrik;opschrikke;opschrikt;opschrikte;opschrikten;
weerspiegelen===weerspiegelen;weerspiegel;weerspiegelde;weerspiegelden;weerspiegele;weerspiegelt;
inschatten===inschatten;inschat;inschatte;
vergissen===vergissen;vergisse;vergiste;vergisten;
inspringen===inspringen;inspring;inspringe;inspringt;insprong;inspronge;insprongen;insprongt;
ontplooien===ontplooien;
blunderen===blunderen;blunder;blunderde;blunderden;blundere;blundert;
heropleven===heropleven;
ecraseren===ecraseren;ecraseer;ecraseerde;ecraseerden;ecrasere;
lasteren===lasteren;laster;lasterde;lasterden;lastere;lastert;
ontlokken===ontlokken;ontlokke;ontlokte;ontlokten;
diepvriezen===diepvriezen;
opspannen===opspannen;opspande;opspanden;opspanne;
aanbieden===aanbieden;aanbied;aanbiede;aanbiedt;aanboden;
opbloeien===opbloeien;opbloei;opbloeide;opbloeiden;opbloeie;opbloeit;
regelen===regelen;regel;regelde;regelden;regele;regelt;
dolen===dolen;dole;doolden;
uitbroeden===uitbroeden;uitbroed;uitbroedde;uitbroedden;uitbroede;uitbroedt;
bedragen===bedragen;bedrage;bedroegen;
uithollen===uithollen;uitholde;uitholden;uitholle;
oppoetsen===oppoetsen;oppoets;oppoetse;oppoetst;oppoetste;oppoetsten;
verbuigen===verbuigen;verbogen;verbuig;verbuige;verbuigt;
ondervragen===ondervragen;ondervraag;ondervraagde;ondervraagden;ondervraagt;ondervrage;ondervroeg;ondervroege;ondervroegen;
doorlopen===doorlopen;doorliepen;doorlope;
wagen===wagen;waagden;wage;
roosteren===roosteren;rooster;roosterde;roosterden;roostere;roostert;
dutten===dutten;dutte;
inkrimpen===inkrimpen;inkrimp;inkrimpe;inkrimpt;inkrompe;inkrompen;
reviseren===reviseren;reviseer;reviseerde;reviseerden;revisere;
poten===poten;pootten;pote;
leven===leven;leve;
bezeren===bezeren;bezeer;bezeerden;bezere;
pesten===pesten;peste;pestten;
beloven===beloven;belove;
aanknopen===aanknopen;aanknoopte;aanknoopten;aanknope;
zwiepen===zwiepen;zwiep;zwiepe;zwiept;zwiepte;zwiepten;
toeëigenen===toeëigenen;
verrichten===verrichten;verricht;verrichte;verrichtte;verrichtten;
kemmen===kemmen;kemden;kemme;
retarderen===retarderen;retardeer;retardeerde;retardeerden;retardeert;retardere;
eren===eren;ere;
aandienen===aandienen;aandien;aandiende;aandienden;aandiene;aandient;
oprukken===oprukken;oprukke;oprukte;oprukten;
herkennen===herkennen;herkende;herkenden;herkenne;
verdikken===verdikken;verdikke;verdikte;verdikten;
bestrijken===bestrijken;bestreke;bestreken;bestrijk;bestrijke;bestrijkt;
procederen===procederen;procedeer;procedeerde;procedeerden;procedeert;procedere;
vechten===vechten;vecht;vechte;vochte;vochten;
afwachten===afwachten;afwacht;afwachte;afwachtte;afwachtten;
blokkeren===blokkeren;blokkeer;blokkeerde;blokkeerden;blokkere;
wuiven===wuiven;wuifden;wuive;
opnemen===opnemen;opname;opnamen;opneem;opneme;
vibreren===vibreren;vibreer;vibreerden;vibrere;
kletsen===kletsen;klets;kletse;kletst;kletste;kletsten;
lambriseren===lambriseren;lambriseer;lambriseerde;lambriseerden;lambriseert;lambrisere;
versmallen===versmallen;versmal;versmalde;versmalden;versmalle;versmalt;
hozen===hozen;hoze;
pieken===pieken;pieke;piekten;
rondtrekken===rondtrekken;rondtrek;rondtrekke;rondtrekt;rondtrokke;rondtrokken;
overdrijven===overdrijven;overdreve;overdreven;overdrijf;overdrijft;overdrijve;
uitademen===uitademen;uitadem;uitademde;uitademden;uitademe;uitademt;
berouwen===berouwen;berouw;berouwde;berouwden;berouwe;berouwt;
onthoofden===onthoofden;onthoofd;onthoofdde;onthoofdden;onthoofde;onthoofdt;
geschieden===geschieden;geschied;geschiedde;geschiedden;geschiede;geschiedt;
verschranzen===verschranzen;verschrans;verschransde;verschransden;verschranst;verschranze;
runnen===runnen;runden;runne;
overgaan===overgaan;overga;overgaat;
ontzeggen===ontzeggen;ontzegde;ontzegden;ontzegge;ontzeiden;
legitimeren===legitimeren;legitimeer;legitimeerde;legitimeerden;legitimeert;legitimere;
opjutten===opjutten;opjutte;
toucheren===toucheren;toucheer;toucheerde;toucheerden;touchere;
aanwenden===aanwenden;aanwend;aanwendde;aanwendden;aanwende;aanwendt;
verwelkomen===verwelkomen;verwelkom;verwelkomde;verwelkomden;verwelkome;verwelkomt;
stilstaan===stilstaan;stilsta;stilstaat;
wemelen===wemelen;wemel;wemelde;wemelden;wemele;wemelt;
passen===passen;passe;pasten;
afleren===afleren;afleer;afleerden;aflere;
plenzen===plenzen;plensden;plenze;
installeren===installeren;installeer;installeerde;installeerden;installeert;installere;
excuseren===excuseren;excuseer;excuseerde;excuseerden;excusere;
verschrikken===verschrikken;verschrik;verschrikke;verschrikt;verschrokke;verschrokken;
afzweren===afzweren;afzweer;afzwere;afzwoere;afzwoeren;
bukken===bukken;bokken;bukke;bukten;
happen===happen;happe;hapten;
knagen===knagen;knaagden;knage;
rioleren===rioleren;rioleer;rioleerden;riolere;
uploaden===uploaden;upload;uploadde;uploadden;uploade;uploadt;
pochen===pochen;
zoomen===zoomen;zoomden;zoome;
inenten===inenten;inent;inente;inentte;inentten;
profiteren===profiteren;
straffen===straffen;straffe;strafte;straften;
verlopen===verlopen;verliepen;verlope;
heersen===heersen;heers;heerse;heerst;heerste;heersten;
opdelen===opdelen;opdeel;opdeelden;opdele;
doorkruisen===doorkruisen;doorkruis;doorkruise;doorkruist;doorkruiste;doorkruisten;
transfigureren===transfigureren;transfigureer;transfigureerde;transfigureerden;transfigureert;transfigurere;
bekoren===bekoren;bekoorden;bekore;
nomineren===nomineren;nomineer;nomineerde;nomineerden;nominere;
bezwendelen===bezwendelen;bezwendel;bezwendelde;bezwendelden;bezwendele;bezwendelt;
priegelen===priegelen;
danken===danken;danke;dankten;
doorhebben===doorhebben;doorhadden;doorheb;doorhebbe;doorhebt;
amerikaniseren===amerikaniseren;
beteren===beteren;beteer;beteerden;beter;beterde;beterden;betere;betert;
laden===laden;laadden;lade;
hospikken===hospikken;hospikke;hospikte;hospikten;
afschermen===afschermen;afscherm;afschermde;afschermden;afscherme;afschermt;
afhakken===afhakken;afhakke;afhakte;afhakten;
bestellen===bestellen;bestelde;bestelden;bestelle;
zieden===zieden;ziedden;ziede;
ontroeren===ontroeren;ontroer;ontroerde;ontroerden;ontroere;ontroert;
opwarmen===opwarmen;
bekritiseren===bekritiseren;bekritiseer;bekritiseerde;bekritiseerden;bekritiseert;bekritisere;
steunen===steunen;steun;steunde;steunden;steune;steunt;
fusilleren===fusilleren;fusilleer;fusilleerde;fusilleerden;fusilleert;fusillere;
opkijken===opkijken;opkeken;opkijk;opkijke;opkijkt;
bevoordelen===bevoordelen;bevoordeel;bevoordeelde;bevoordeelden;bevoordeelt;bevoordele;
dreigen===dreigen;dreig;dreigde;dreigden;dreige;dreigt;
laten===laten;late;
munten===munten;munte;muntten;
nabootsen===nabootsen;naboots;nabootse;nabootst;nabootste;nabootsten;
stammen===stammen;stamde;stamden;stamme;
vernemen===vernemen;vername;vernamen;verneem;verneme;
verstellen===verstellen;verstel;verstelde;verstelden;verstelle;verstelt;
censureren===censureren;censureer;censureerde;censureerden;censureert;censurere;
pinnen===pinnen;pinden;pinne;
krijten===krijten;kreten;krijt;krijte;krijtte;krijtten;
afnemen===afnemen;afname;afnamen;afneem;afneme;
versnipperen===versnipperen;versnipper;versnipperde;versnipperden;versnippere;versnippert;
verschepen===verschepen;verscheep;verscheept;verscheepte;verscheepten;verschepe;
kampen===kampen;kampe;kampten;
versjteren===versjteren;versjteer;versjteerde;versjteerden;versjteert;versjtere;
africhten===africhten;africht;africhte;africhtte;africhtten;
schrijven===schrijven;schreven;schrijve;
kwijlen===kwijlen;kwijl;kwijlde;kwijlden;kwijle;kwijlt;
raaskallen===raaskallen;raaskal;raaskalde;raaskalden;raaskalle;raaskalt;
toebehoren===toebehoren;toebehoor;toebehoorde;toebehoorden;toebehoort;toebehore;
temmen===temmen;temden;temme;
bestieren===bestieren;bestier;bestierde;bestierden;bestiere;bestiert;
onteren===onteren;onteer;onteerden;ontere;
inlossen===inlossen;inlosse;inloste;inlosten;
verhullen===verhullen;verhulde;verhulden;verhulle;
verstijven===verstijven;verstijf;verstijfde;verstijfden;verstijft;verstijve;
vertrouwen===vertrouwen;vertrouw;vertrouwde;vertrouwden;vertrouwe;vertrouwt;
weken===weken;weekten;weke;
aangeven===aangeven;aangave;aangaven;aangeef;aangeve;
grijsrijden===grijsrijden;grijsrede;grijsreden;grijsrijd;grijsrijde;grijsrijdt;
pruttelen===pruttelen;pruttel;pruttelde;pruttelden;pruttele;pruttelt;
weergalmen===weergalmen;weergalm;weergalmde;weergalmden;weergalme;weergalmt;
spouwen===spouwen;spouw;spouwde;spouwden;spouwe;spouwt;
trillen===trillen;trilde;trilden;trille;
gorden===gorden;gordden;gorde;
bijzetten===bijzetten;bijzette;
inspuiten===inspuiten;inspoten;inspuit;inspuite;
aanwijzen===aanwijzen;aanwezen;aanwijze;
achteruitgaan===achteruitgaan;achteruitga;achteruitgaat;achteruitging;achteruitginge;achteruitgingen;achteruitgingt;
veroorloven===veroorloven;veroorloof;veroorloofden;veroorlooft;veroorlove;
racen===racen;race;racet;raceten;
veredelen===veredelen;
etaleren===etaleren;etaleer;etaleerden;etalere;
benutten===benutten;benutte;
braden===braden;braadden;brade;
fabrieken===fabrieken;
begrijpen===begrijpen;begrepen;begrijp;begrijpe;begrijpt;
raken===raken;raakten;rake;
dichtbinden===dichtbinden;dichtbind;dichtbinde;dichtbindt;dichtbond;dichtbonde;dichtbonden;dichtbondt;
lurken===lurken;
winden===winden;winde;wonden;
kruisigen===kruisigen;kruisig;kruisigde;kruisigden;kruisige;kruisigt;
hagelen===hagelen;hagel;hagelde;hagelden;hagele;hagelt;
dansen===dansen;danse;dansten;
beteugelen===beteugelen;beteugel;beteugelde;beteugelden;beteugele;beteugelt;
fosforesceren===fosforesceren;fosforesceer;fosforesceerde;fosforesceerden;fosforesceert;fosforescere;
uitschijnen===uitschijnen;uitscheen;uitschene;uitschenen;uitschijn;uitschijne;uitschijnt;
doorbreken===doorbreken;doorbrak;doorbrake;doorbraken;doorbreek;doorbreekt;doorbreke;
looien===looien;looiden;looie;
aftasten===aftasten;aftast;aftaste;aftastte;aftastten;
zwartmaken===zwartmaken;zwartmaak;zwartmaakt;zwartmaakte;zwartmaakten;zwartmake;
ontkomen===ontkomen;ontkom;ontkome;ontkomt;ontkwamen;
ruimen===ruimen;ruimden;ruime;
kelderen===kelderen;kelder;kelderde;kelderden;keldere;keldert;
gewagen===gewagen;gewaagden;gewage;
triomferen===triomferen;triomfeer;triomfeerde;triomfeerden;triomfeert;triomfere;
avanceren===avanceren;avanceer;avanceerde;avanceerden;avancere;
melden===melden;meldden;melde;
slachten===slachten;slacht;slachte;slachtte;slachtten;
putten===putten;putte;
uitvergroten===uitvergroten;uitvergroot;uitvergrootte;uitvergrootten;uitvergrote;
huiken===huiken;huike;huikten;
bellen===bellen;belden;belle;
koekeloeren===koekeloeren;koekeloer;koekeloerde;koekeloerden;koekeloere;koekeloert;
tellen===tellen;telden;telle;
duiden===duiden;duidden;duide;
wapenen===wapenen;wapen;wapende;wapenden;wapene;wapent;
vieren===vieren;vierden;viere;
kidnappen===kidnappen;kidnappe;kidnapte;kidnapten;
vervangen===vervangen;vervang;vervange;vervangt;vervinge;vervingen;
farmen===farmen;farmden;farme;
opsouperen===opsouperen;opsoupeer;opsoupeerde;opsoupeerden;opsoupeert;opsoupere;
zwerven===zwerven;zwerve;zwierve;zwierven;
overlijden===overlijden;overlede;overleden;overlijd;overlijde;overlijdt;
bemerken===bemerken;bemerk;bemerke;bemerkt;bemerkte;bemerkten;
fragmenteren===fragmenteren;fragmenteer;fragmenteerde;fragmenteerden;fragmenteert;fragmentere;
verslechteren===verslechteren;verslechter;verslechterde;verslechterden;verslechtere;verslechtert;
opbellen===opbellen;opbelde;opbelden;opbelle;
uitstralen===uitstralen;uitstraal;uitstraalde;uitstraalden;uitstraalt;uitstrale;
worteltrekken===worteltrekken;
inwilligen===inwilligen;inwillig;inwilligde;inwilligden;inwillige;inwilligt;
herleven===herleven;herleef;herleefden;herleve;
mishandelen===mishandelen;mishandel;mishandelde;mishandelden;mishandele;mishandelt;
stompen===stompen;stomp;stompe;stompt;stompte;stompten;
verschuilen===verschuilen;verschole;verscholen;verschuil;verschuile;verschuilt;
strelen===strelen;streel;streelden;strele;
verzinnen===verzinnen;verzinne;verzonne;verzonnen;
afstrijken===afstrijken;
wijlen===wijlen;
inloggen===inloggen;inlogde;inlogden;inlogge;
variëren===variëren;varieerden;variëre;
verhinderen===verhinderen;verhinder;verhinderde;verhinderden;verhindere;verhindert;
contacteren===contacteren;contacteer;contacteerde;contacteerden;contacteert;contactere;
uitsluiten===uitsluiten;uitslote;uitsloten;uitsluit;uitsluite;
hechten===hechten;hecht;hechte;hechtte;hechtten;
opbrengen===opbrengen;opbreng;opbrenge;opbrengt;
attaqueren===attaqueren;attaqueer;attaqueerde;attaqueerden;attaqueert;attaquere;
biechten===biechten;biecht;biechte;biechtte;biechtten;
augmenteren===augmenteren;augmenteer;augmenteerde;augmenteerden;augmenteert;augmentere;
binnenkomen===binnenkomen;binnenkom;binnenkome;binnenkomt;binnenkwame;binnenkwamen;
tafelen===tafelen;tafel;tafelde;tafelden;tafele;tafelt;
afkopen===afkopen;afkope;
haten===haten;haatten;hate;
zetten===zetten;zette;
aanbidden===aanbidden;aanbaden;aanbidde;
pieren===pieren;pierden;piere;
bekken trekken===bekken trekken;bekkentrekken;
beschadigen===beschadigen;beschadig;beschadigde;beschadigden;beschadige;beschadigt;
optillen===optillen;optilde;optilden;optille;
kerstenen===kerstenen;kersten;kerstende;kerstenden;kerstene;kerstent;
uitrekken===uitrekken;uitrekke;uitrekte;uitrekten;
lanceren===lanceren;lanceer;lanceerden;lancere;
amuseren===amuseren;amuseer;amuseerden;amusere;
graveren===graveren;graveer;graveerden;gravere;
concentreren===concentreren;concentreer;concentreerde;concentreerden;concentreert;concentrere;
begeren===begeren;begeer;begeerden;begere;
ontsluieren===ontsluieren;ontsluier;ontsluierde;ontsluierden;ontsluiere;ontsluiert;
steken===steken;staken;steke;
trouwen===trouwen;trouw;trouwde;trouwden;trouwe;trouwt;
teren===teren;teerden;tere;
matten===matten;matte;
afleiden===afleiden;afleid;afleidde;afleidden;afleide;afleidt;
verzadigen===verzadigen;verzadig;verzadigde;verzadigden;verzadige;verzadigt;
wenden===wenden;wendden;wende;
vleien===vleien;vleiden;vleie;
afplatten===afplatten;afplatte;
lullen===lullen;lulden;lulle;
opsodemieteren===opsodemieteren;opsodemieter;opsodemieterde;opsodemieterden;opsodemietere;opsodemietert;
schreien===schreien;
verbruiken===verbruiken;verbruik;verbruike;verbruikt;verbruikte;verbruikten;
afkoelen===afkoelen;afkoel;afkoelde;afkoelden;afkoele;afkoelt;
bereiden===bereiden;bereid;bereidde;bereidden;bereide;bereidt;
mennen===mennen;menden;menne;
zwepen===zwepen;zweepten;zwepe;
onderbreken===onderbreken;onderbrak;onderbrake;onderbraken;onderbreek;onderbreekt;onderbreke;
wegkwijnen===wegkwijnen;wegkwijn;wegkwijnde;wegkwijnden;wegkwijne;wegkwijnt;
oplopen===oplopen;opliepen;oplope;
verloochenen===verloochenen;verloochen;verloochende;verloochenden;verloochene;verloochent;
springen===springen;spring;springe;springt;spronge;sprongen;
huiveren===huiveren;huiver;huiverde;huiverden;huivere;huivert;
archiveren===archiveren;archiveer;archiveerde;archiveerden;archiveert;archivere;
smokkelen===smokkelen;smokkel;smokkelde;smokkelden;smokkele;smokkelt;
weigeren===weigeren;weiger;weigerde;weigerden;weigere;weigert;
batsen===batsen;batse;batsten;
uitlopen===uitlopen;uitliepen;uitlope;
revindiceren===revindiceren;revindiceer;revindiceerde;revindiceerden;revindiceert;revindicere;
stallen===stallen;stalde;stalden;stalle;
opsommen===opsommen;opsomde;opsomden;opsomme;
prognosticeren===prognosticeren;prognosticeer;prognosticeerde;prognosticeerden;prognosticeert;prognosticere;
overhandigen===overhandigen;overhandig;overhandigde;overhandigden;overhandige;overhandigt;
halen===halen;haalden;hale;
uitschelden===uitschelden;uitscheld;uitschelde;uitscheldt;uitschold;uitscholde;uitscholden;uitscholdt;
karnen===karnen;karnden;karne;
aanvullen===aanvullen;aanvulde;aanvulden;aanvulle;
afdwalen===afdwalen;afdwaalden;afdwale;
repareren===repareren;repareer;repareerde;repareerden;reparere;
berechten===berechten;berecht;berechte;berechtte;berechtten;
verwittigen===verwittigen;verwittig;verwittigde;verwittigden;verwittige;verwittigt;
assisteren===assisteren;assisteer;assisteerde;assisteerden;assisteert;assistere;
aftreden===aftreden;aftrade;aftraden;aftrede;aftreed;
portretteren===portretteren;portretteer;portretteerde;portretteerden;portretteert;portrettere;
benieuwen===benieuwen;benieuw;benieuwde;benieuwden;benieuwe;benieuwt;
uitrazen===uitrazen;uitraasden;uitraze;
liplezen===liplezen;liplaze;liplazen;liplees;lipleze;
inblazen===inblazen;inblaze;inbliezen;
beangstigen===beangstigen;beangstig;beangstigde;beangstigden;beangstige;beangstigt;
omhelzen===omhelzen;omhelsden;omhelze;
scheiden===scheiden;scheid;scheidde;scheidden;scheide;scheidt;
wannen===wannen;wanden;wanne;
marmeren===marmeren;marmer;marmerde;marmerden;marmere;marmert;
aanvoegen===aanvoegen;aanvoeg;aanvoegde;aanvoegden;aanvoege;aanvoegt;
uitbranden===uitbranden;uitbrand;uitbrandde;uitbrandden;uitbrande;uitbrandt;
voorschieten===voorschieten;voorschiet;voorschiete;voorschiett;voorschote;voorschoten;
luisteren===luisteren;luister;luisterde;luisterden;luistere;luistert;
ontfermen===ontfermen;ontferm;ontfermde;ontfermden;ontferme;ontfermt;
kontneuken===kontneuken;kontneuk;kontneuke;kontneukt;kontneukte;kontneukten;
doezelen===doezelen;doezel;doezelde;doezelden;doezele;doezelt;
aanvragen===aanvragen;aanvraagde;aanvraagden;aanvrage;aanvroegen;
ontginnen===ontginnen;ontginne;ontgonne;ontgonnen;
bedriegen===bedriegen;bedrieg;bedriege;bedriegt;bedrogen;
doceren===doceren;doceer;doceerden;docere;
piepen===piepen;piepe;piepten;
rammelen===rammelen;rammel;rammelde;rammelden;rammele;rammelt;
rolschaatsen===rolschaatsen;rolschaats;rolschaatse;rolschaatst;rolschaatste;rolschaatsten;
veilen===veilen;veilden;veile;
bezielen===bezielen;beziel;bezielde;bezielden;beziele;bezielt;
koelen===koelen;koelden;koele;
googelen===googelen;googel;googelde;googelden;googele;googelt;
versturen===versturen;versture;verstuurde;verstuurden;
verfoeien===verfoeien;verfoei;verfoeide;verfoeiden;verfoeie;verfoeit;
bedanken===bedanken;bedank;bedanke;bedankt;bedankte;bedankten;
afstaan===afstaan;afsta;afstaat;
klonen===klonen;klone;kloonden;
vergiftigen===vergiftigen;vergiftig;vergiftigde;vergiftigden;vergiftige;vergiftigt;
ondervinden===ondervinden;ondervind;ondervinde;ondervindt;ondervond;ondervonde;ondervonden;ondervondt;
beklemmen===beklemmen;beklemde;beklemden;beklemme;
omvatten===omvatten;omvatte;
adopteren===adopteren;adopteer;adopteerde;adopteerden;adoptere;
kloven===kloven;klove;
opstappen===opstappen;opstappe;opstapte;opstapten;
spijten===spijten;speten;spijt;spijte;
fabriceren===fabriceren;fabriceer;fabriceerde;fabriceerden;fabriceert;fabricere;
afstoten===afstoten;afstieten;afstootten;afstote;
declineren===declineren;declineer;declineerde;declineerden;declineert;declinere;
ledigen===ledigen;ledig;ledigde;ledigden;ledige;ledigt;
opwaarderen===opwaarderen;opwaardeer;opwaardeerde;opwaardeerden;opwaardeert;opwaardere;
hebben===hebben;hebbe;
witwassen===witwassen;witwasse;witwaste;witwasten;
glanzen===glanzen;glansden;glanze;
hergroeperen===hergroeperen;hergroepeer;hergroepeerde;hergroepeerden;hergroepeert;hergroepere;
bespieden===bespieden;bespied;bespiedde;bespiedden;bespiede;bespiedt;
sms'en===sms'en;sms'e;sms'ten;
onderbrengen===onderbrengen;onderbreng;onderbrenge;onderbrengt;
gedogen===gedogen;gedoge;gedoogden;
rectificeren===rectificeren;rectificeer;rectificeerde;rectificeerden;rectificeert;rectificere;
bekruipen===bekruipen;bekropen;bekruip;bekruipe;bekruipt;
bezoedelen===bezoedelen;bezoedel;bezoedelde;bezoedelden;bezoedele;bezoedelt;
functioneren===functioneren;functioneer;functioneerde;functioneerden;functioneert;functionere;
zeuren===zeuren;zeurden;zeure;
vatten===vatten;vatte;
manifesteren===manifesteren;manifesteer;manifesteerde;manifesteerden;manifesteert;manifestere;
mijmeren===mijmeren;mijmer;mijmerde;mijmerden;mijmere;mijmert;
insneeuwen===insneeuwen;insneeuw;insneeuwde;insneeuwden;insneeuwe;insneeuwt;
reageren===reageren;reageer;reageerden;reagere;
leasen===leasen;lease;leasede;leaseden;leaset;leasete;leaseten;
bevinden===bevinden;bevind;bevinde;bevindt;bevonde;bevonden;
betitelen===betitelen;betitel;betitelde;betitelden;betitele;betitelt;
verdragen===verdragen;verdrage;verdroegen;
compenseren===compenseren;compenseer;compenseerde;compenseerden;compenseert;compensere;
controleren===controleren;controleer;controleerde;controleerden;controleert;controlere;
overeenkomen===overeenkomen;overeenkom;overeenkome;overeenkomt;overeenkwame;overeenkwamen;
verluchtigen===verluchtigen;verluchtig;verluchtigde;verluchtigden;verluchtige;verluchtigt;
afkeuren===afkeuren;afkeur;afkeurde;afkeurden;afkeure;afkeurt;
walmen===walmen;walmden;walme;
hinten===hinten;hinte;hintten;
vertragen===vertragen;vertraagde;vertraagden;vertrage;
doortikken===doortikken;doortik;doortikke;doortikt;doortikte;doortikten;
zoeken===zoeken;zoeke;
afvaardigen===afvaardigen;afvaardig;afvaardigde;afvaardigden;afvaardige;afvaardigt;
vooruitspoelen===vooruitspoelen;vooruitspoel;vooruitspoelde;vooruitspoelden;vooruitspoele;vooruitspoelt;
verpletteren===verpletteren;verpletter;verpletterde;verpletterden;verplettere;verplettert;
opvallen===opvallen;opvalle;opvielen;
vervuilen===vervuilen;vervuil;vervuilde;vervuilden;vervuile;vervuilt;
bedekken===bedekken;bedekke;bedekte;bedekten;
sloffen===sloffen;sloffe;slofte;sloften;
kalken===kalken;kalke;kalkten;
niezen===niezen;niesden;niesen;nieze;sniezen;
volstaan===volstaan;volsta;volstaat;
boeken===boeken;boeke;boekten;
nabewerken===nabewerken;nabewerk;nabewerke;nabewerkt;nabewerkte;nabewerkten;
bonken===bonken;bonke;bonkten;
knuffelen===knuffelen;knuffel;knuffelde;knuffelden;knuffele;knuffelt;
omsingelen===omsingelen;omsingel;omsingelde;omsingelden;omsingele;omsingelt;
opendoen===opendoen;opendeden;opendeed;opendoe;opendoet;
legeren===legeren;legeer;legeerden;leger;legerde;legerden;legere;legert;
belenen===belenen;beleen;beleenden;beleent;belene;
manicuren===manicuren;manicure;manicuurde;manicuurden;
bezwijmen===bezwijmen;bezwijm;bezwijmde;bezwijmden;bezwijme;bezwijmt;
beminnen===beminnen;beminde;beminden;beminne;
ambiëren===ambiëren;ambieerden;ambiëre;
schuifelen===schuifelen;schuifel;schuifelde;schuifelden;schuifele;schuifelt;
gebieden===gebieden;gebied;gebiede;gebiedt;geboden;
schranzen===schranzen;schransden;schranze;
overgooien===overgooien;overgooi;overgooide;overgooiden;overgooie;overgooit;
legaliseren===legaliseren;legaliseer;legaliseerde;legaliseerden;legaliseert;legalisere;
toe-eigenen===toe-eigenen;
heroveren===heroveren;herover;heroverde;heroverden;herovere;herovert;
blussen===blussen;blusse;bluste;blusten;
introduceren===introduceren;introduceer;introduceerde;introduceerden;introduceert;introducere;
afmeten===afmeten;afmate;afmaten;afmeet;afmete;
bijwerken===bijwerken;bijwerk;bijwerke;bijwerkt;bijwerkte;bijwerkten;
drogen===drogen;droge;droogden;
weerspreken===weerspreken;weersprak;weersprake;weerspraken;weerspreek;weerspreekt;weerspreke;
verwonden===verwonden;verwond;verwondde;verwondden;verwonde;verwondt;
indutten===indutten;indutte;
volmaken===volmaken;volmaakten;volmake;
samensmelten===samensmelten;samensmelt;samensmelte;samensmolt;samensmolte;samensmolten;
jassen===jassen;jasse;jasten;
gelijkrichten===gelijkrichten;
argumenteren===argumenteren;argumenteer;argumenteerde;argumenteerden;argumenteert;argumentere;
grijpen===grijpen;grepen;grijp;grijpe;grijpt;
kenmerken===kenmerken;kenmerk;kenmerke;kenmerkt;kenmerkte;kenmerkten;
bereiken===bereiken;bereik;bereike;bereikt;bereikte;bereikten;
nahouden===nahouden;nahoud;nahoude;nahoudt;
uitdagen===uitdagen;uitdaagden;uitdage;
bougeren===bougeren;
jijen===jijen;jijden;jije;
zengen===zengen;zengden;zenge;
transporteren===transporteren;transporteer;transporteerde;transporteerden;transporteert;transportere;
wiebelen===wiebelen;wiebel;wiebelde;wiebelden;wiebele;wiebelt;
omwinden===omwinden;omwind;omwinde;omwindt;omwonde;omwonden;
sleutelen===sleutelen;sleutel;sleutelde;sleutelden;sleutele;sleutelt;
razen===razen;raze;
kwispelen===kwispelen;kwispel;kwispelde;kwispelden;kwispele;kwispelt;
zwemmen===zwemmen;zwemme;zwomme;zwommen;
hopen===hopen;hoopten;hope;
joggen===joggen;jogden;jogge;
muilen===muilen;muilden;muile;
maskeren===maskeren;masker;maskerde;maskerden;maskere;maskert;
beschikken===beschikken;beschik;beschikke;beschikt;beschikte;beschikten;
houden===houden;houde;
markeren===markeren;markeer;markeerden;markere;
muilperen===muilperen;muilpeer;muilpeerde;muilpeerden;muilpere;
ontstaan===ontstaan;ontsta;ontstaat;
kletsregenen===kletsregenen;kletsregen;kletsregende;kletsregenden;kletsregene;kletsregent;
klikken===klikken;klikke;klikte;klikten;
vervliegen===vervliegen;vervlieg;vervliege;vervliegt;vervloge;vervlogen;
inlaten===inlaten;inlate;inlieten;
bijstellen===bijstellen;bijstel;bijstelde;bijstelden;bijstelle;bijstelt;
compliceren===compliceren;compliceer;compliceerde;compliceerden;compliceert;complicere;
ratelen===ratelen;ratel;ratelde;ratelden;ratele;ratelt;
spekken===spekken;spekke;spekte;spekten;
kanen===kanen;kaanden;kane;
opkalefateren===opkalefateren;opkalefater;opkalefaterde;opkalefaterden;opkalefatere;opkalefatert;
uitkiezen===uitkiezen;uitkieze;uitkozen;
wreken===wreken;
belegeren===belegeren;beleger;belegerde;belegerden;belegere;belegert;
doven===doven;dove;
beluisteren===beluisteren;beluister;beluisterde;beluisterden;beluistere;beluistert;
openbloeien===openbloeien;openbloei;openbloeide;openbloeiden;openbloeie;openbloeit;
sieren===sieren;sierden;siere;
opzadelen===opzadelen;opzadel;opzadelde;opzadelden;opzadele;opzadelt;
muiten===muiten;muite;muitten;
verkrachten===verkrachten;verkracht;verkrachte;verkrachtte;verkrachtten;
aandragen===aandragen;aandrage;aandroegen;
beplakken===beplakken;beplakke;beplakte;beplakten;
wintersporten===wintersporten;wintersport;wintersporte;wintersportte;wintersportten;
oogsten===oogsten;oogst;oogste;oogstte;oogstten;
weerhouden===weerhouden;weerhielden;weerhou;weerhoud;weerhoude;weerhoudt;
bruiken===bruiken;bruik;bruike;bruikt;bruikte;bruikten;
mokken===mokken;mokke;mokten;
sterken===sterken;sterk;sterke;sterkt;sterkte;sterkten;
uitsparen===uitsparen;uitspaarde;uitspaarden;uitspare;
bekendmaken===bekendmaken;bekendmaak;bekendmaakt;bekendmaakte;bekendmaakten;bekendmake;
boten===boten;
afspelen===afspelen;afspeel;afspeelden;afspele;
bewonen===bewonen;bewone;bewoon;bewoonden;
maffen===maffen;maffe;maften;
splitsen===splitsen;splits;splitse;splitst;splitste;splitsten;
verflauwen===verflauwen;verflauw;verflauwde;verflauwden;verflauwe;verflauwt;
vervelen===vervelen;verveel;verveelden;vervele;
gesticuleren===gesticuleren;gesticuleer;gesticuleerde;gesticuleerden;gesticuleert;gesticulere;
bloeien===bloeien;bloei;bloeide;bloeiden;bloeie;bloeit;
verjaren===verjaren;verjaarden;verjare;
teruggeven===teruggeven;teruggave;teruggaven;teruggeef;teruggeeft;teruggeve;
verdoven===verdoven;verdoofden;verdove;
bemoeien===bemoeien;bemoei;bemoeide;bemoeiden;bemoeie;bemoeit;
tatoeëren===tatoeëren;tatoeëer;tatoeëerde;tatoeëerden;tatoeëre;
slopen===slopen;sloopten;slope;
machtsverheffen===machtsverheffen;
benemen===benemen;bename;benamen;beneem;beneme;
uithouwen===uithouwen;uithieuwen;uithouw;uithouwde;uithouwden;uithouwe;uithouwt;
wegnemen===wegnemen;wegname;wegnamen;wegneem;wegneme;
repeteren===repeteren;repeteer;repeteerde;repeteerden;repetere;
glimmen===glimmen;glimme;glomen;
donderen===donderen;donder;donderde;donderden;dondere;dondert;
opfokken===opfokken;opfokke;opfokte;opfokten;
intimideren===intimideren;intimideer;intimideerde;intimideerden;intimideert;intimidere;
verbinden===verbinden;verbind;verbinde;verbindt;verbonde;verbonden;
offeren===offeren;offer;offerde;offerden;offere;offert;
behartigen===behartigen;behartig;behartigde;behartigden;behartige;behartigt;
enten===enten;ente;entten;
uitschieten===uitschieten;uitschiet;uitschiete;uitschote;uitschoten;
overhalen===overhalen;overhaalde;overhaalden;overhale;
kwaken===kwaken;kwaakten;kwake;
kennismaken===kennismaken;kennismaak;kennismaakt;kennismaakte;kennismaakten;kennismake;
sjokken===sjokken;sjokke;sjokte;sjokten;
uitloggen===uitloggen;uitlogde;uitlogden;uitlogge;
beboeten===beboeten;beboet;beboete;beboette;beboetten;
delven===delven;delve;dolven;
verhoren===verhoren;verhoorden;verhore;
bezien===bezien;bezagen;bezie;beziet;
terugtreden===terugtreden;terugtrad;terugtrade;terugtraden;terugtrede;terugtreed;terugtreedt;
aanhoren===aanhoren;aanhoorden;aanhore;
rekenen===rekenen;reken;rekende;rekenden;rekene;rekent;
bewonderen===bewonderen;bewonder;bewonderde;bewonderden;bewondere;bewondert;
falen===falen;faalden;fale;
aaneendraaien===aaneendraaien;aaneendraai;aaneendraaide;aaneendraaiden;aaneendraaie;aaneendraait;
bestempelen===bestempelen;bestempel;bestempelde;bestempelden;bestempele;bestempelt;
ontberen===ontberen;ontbeer;ontbeerden;ontbere;
bibberen===bibberen;bibber;bibberde;bibberden;bibbere;bibbert;
beledigen===beledigen;beledig;beledigde;beledigden;beledige;beledigt;
bedrijven===bedrijven;bedreven;bedrijve;
mondialiseren===mondialiseren;mondialiseer;mondialiseerde;mondialiseerden;mondialiseert;mondialisere;
bruisen===bruisen;bruis;bruise;bruist;bruiste;bruisten;
spelen===spelen;speelden;spele;
werven===werven;werve;wierven;
vertakken===vertakken;vertakke;vertakte;vertakten;
huren===huren;hure;huurden;
wegvagen===wegvagen;wegvaagden;wegvage;
buitensluiten===buitensluiten;buitenslote;buitensloten;buitensluit;buitensluite;
jammeren===jammeren;jammer;jammerde;jammerden;jammere;jammert;
breidelen===breidelen;breidel;breidelde;breidelden;breidele;breidelt;
beklemtonen===beklemtonen;beklemtone;beklemtoon;beklemtoonde;beklemtoonden;beklemtoont;
frauderen===frauderen;fraudeer;fraudeerde;fraudeerden;fraudere;
wortelen===wortelen;wortel;wortelde;wortelden;wortele;wortelt;
hergebruiken===hergebruiken;hergebruik;hergebruike;hergebruikt;hergebruikte;hergebruikten;
opnoemen===opnoemen;opnoem;opnoemde;opnoemden;opnoeme;opnoemt;
rollen===rollen;rolden;rolle;
immigreren===immigreren;immigreer;immigreerde;immigreerden;immigreert;immigrere;
rillen===rillen;rilden;rille;
wedden===wedden;wedde;
bebossen===bebossen;bebosse;beboste;bebosten;
meeleveren===meeleveren;meelever;meeleverde;meeleverden;meelevere;meelevert;
bewieroken===bewieroken;bewieroke;bewierook;bewierookt;bewierookte;bewierookten;
instappen===instappen;instappe;instapte;instapten;
buitelen===buitelen;buitel;buitelde;buitelden;buitele;buitelt;
preken===preken;
snappen===snappen;snappe;snapte;snapten;
presteren===presteren;presteer;presteerde;presteerden;prestere;
betoveren===betoveren;betover;betoverde;betoverden;betovere;betovert;
voorspellen===voorspellen;voorspel;voorspelde;voorspelden;voorspelle;voorspelt;
abonneren===abonneren;abonneer;abonneerde;abonneerden;abonnere;
achteromkijken===achteromkijken;achteromkeek;achteromkeekt;achteromkeke;achteromkeken;achteromkijk;achteromkijke;achteromkijkt;
strijden===strijden;streden;strijd;strijde;strijdt;
betamen===betamen;betaamden;betame;
overmaken===overmaken;overmaakte;overmaakten;overmake;
verdenken===verdenken;verdenk;verdenke;verdenkt;
lummelen===lummelen;lummel;lummelde;lummelden;lummele;lummelt;
opmerken===opmerken;opmerk;opmerke;opmerkt;opmerkte;opmerkten;
verjongen===verjongen;verjong;verjongde;verjongden;verjonge;verjongt;
specificeren===specificeren;specificeer;specificeerde;specificeerden;specificeert;specificere;
verstoten===verstoten;verstieten;verstootte;verstootten;verstote;
aanslaan===aanslaan;aansla;aanslaat;
versterken===versterken;versterk;versterke;versterkt;versterkte;versterkten;
bestuderen===bestuderen;bestudeer;bestudeerde;bestudeerden;bestudeert;bestudere;
meten===meten;maten;mete;
inschrijven===inschrijven;inschreve;inschreven;inschrijf;inschrijft;inschrijve;
vergoeden===vergoeden;vergoed;vergoedde;vergoedden;vergoede;vergoedt;
vertonen===vertonen;vertone;vertoon;vertoonden;
hamsteren===hamsteren;hamster;hamsterde;hamsterden;hamstere;hamstert;
suizen===suizen;suisden;suize;
afzoeken===afzoeken;afzoek;afzoeke;afzoekt;
verhouten===verhouten;verhout;verhoute;verhoutte;verhoutten;
heffen===heffen;heffe;
turen===turen;ture;tuurden;
zakken===zakken;zakke;zakten;
vereren===vereren;vereer;vereerden;verere;
afbeelden===afbeelden;afbeeld;afbeeldde;afbeeldden;afbeelde;afbeeldt;
bladeren===bladeren;blader;bladerde;bladerden;bladere;bladert;
corrigeren===corrigeren;corrigeer;corrigeerde;corrigeerden;corrigeert;corrigere;
snuiven===snuiven;snoven;snuive;
verblinden===verblinden;verblind;verblindde;verblindden;verblinde;verblindt;
schatten===schatten;schatte;
afrollen===afrollen;afrolde;afrolden;afrolle;
tieren===tieren;tierden;tiere;
telefoneren===telefoneren;telefoneer;telefoneerde;telefoneerden;telefoneert;telefonere;
verkwisten===verkwisten;verkwist;verkwiste;verkwistte;verkwistten;
pandoeren===pandoeren;pandoer;pandoerde;pandoerden;pandoere;pandoert;
ijlen===ijlen;ijlden;ijle;
gokken===gokken;gokke;gokten;
culmineren===culmineren;culmineer;culmineerde;culmineerden;culmineert;culminere;
uitmonden===uitmonden;uitmond;uitmondde;uitmondden;uitmonde;uitmondt;
digitaliseren===digitaliseren;digitaliseer;digitaliseerde;digitaliseerden;digitaliseert;digitalisere;
financieren===financieren;financier;financierde;financierden;financiere;financiert;
aanspoelen===aanspoelen;aanspoel;aanspoelde;aanspoelden;aanspoele;aanspoelt;
bespelen===bespelen;bespeel;bespeelden;bespele;
breken===breken;braken;breke;
verheffen===verheffen;verheffe;
bekostigen===bekostigen;bekostig;bekostigde;bekostigden;bekostige;bekostigt;
trakteren===trakteren;trakteer;trakteerde;trakteerden;traktere;
kliken===kliken;
smijten===smijten;smeten;smijt;smijte;
opspringen===opspringen;opspring;opspringe;opspringt;opsprong;opspronge;opsprongen;opsprongt;
reserveren===reserveren;reserveer;reserveerde;reserveerden;reserveert;reservere;
hijgen===hijgen;hijgden;hijge;
blootleggen===blootleggen;blootleg;blootlegde;blootlegden;blootlegge;blootlegt;
branden===branden;brand;brandde;brandden;brande;brandt;
meppen===meppen;meppe;mepten;
afwisselen===afwisselen;afwissel;afwisselde;afwisselden;afwissele;afwisselt;
redden===redden;redde;
verroesten===verroesten;verroest;verroeste;verroestte;verroestten;
toelaten===toelaten;toelate;toelieten;
treiteren===treiteren;
omcirkelen===omcirkelen;
reinigen===reinigen;reinig;reinigde;reinigden;reinige;reinigt;
zakkenrollen===zakkenrollen;
reduceren===reduceren;reduceer;reduceerde;reduceerden;reducere;
verwijden===verwijden;verwijd;verwijdde;verwijdden;verwijde;verwijdt;
gisten===gisten;giste;gistten;
bezighouden===bezighouden;bezighielden;bezighou;bezighoud;bezighoude;bezighoudt;
doorstrepen===doorstrepen;doorstreep;doorstreept;doorstreepte;doorstreepten;doorstrepe;
pipetteren===pipetteren;pipetteer;pipetteerde;pipetteerden;pipetteert;pipettere;
klieren===klieren;klier;klierde;klierden;kliere;kliert;
golfen===golfen;golfe;golften;
misleiden===misleiden;misleid;misleidde;misleidden;misleide;misleidt;
inhalen===inhalen;inhaalden;inhale;
bedelen===bedelen;bedeel;bedeelden;bedeelen;bedel;bedelde;bedelden;bedele;bedelt;
wrijten===wrijten;wreten;wrijt;wrijte;
schenken===schenken;schenk;schenke;schenkt;schonke;schonken;
smullen===smullen;smulde;smulden;smulle;
onderzoeken===onderzoeken;onderzochten;onderzoek;onderzoeke;onderzoekt;
poepen===poepen;poepe;poepten;
kappen===kappen;kappe;kapten;
zwelgen===zwelgen;zwelg;zwelgde;zwelgden;zwelge;zwelgt;zwolge;zwolgen;
afmelden===afmelden;afmeld;afmeldde;afmeldden;afmelde;afmeldt;
zorgen===zorgen;zorgden;zorge;
ontvolken===ontvolken;ontvolk;ontvolke;ontvolkt;ontvolkte;ontvolkten;
vlammen===vlammen;vlamde;vlamden;vlamme;
verdrievoudigen===verdrievoudigen;verdrievoudig;verdrievoudigde;verdrievoudigden;verdrievoudige;verdrievoudigt;
aanduiden===aanduiden;aanduid;aanduidde;aanduidden;aanduide;aanduidt;
ontleden===ontleden;ontlede;ontleed;ontleedden;
verdunnen===verdunnen;verdunde;verdunden;verdunne;
verslaan===verslaan;versla;verslaat;
leegmaken===leegmaken;leegmaakte;leegmaakten;leegmake;
kritiseren===kritiseren;kritiseer;kritiseerde;kritiseerden;kritiseert;kritisere;
doorkrijgen===doorkrijgen;doorkrege;doorkregen;doorkrijg;doorkrijge;doorkrijgt;
sluikstorten===sluikstorten;sluikstort;sluikstorte;sluikstortte;sluikstortten;
beslissen===beslissen;beslisse;besliste;beslisten;
definiëren===definiëren;definieer;definieerden;definiëre;
besnijden===besnijden;besneden;besnijd;besnijde;besnijdt;
verhouden===verhouden;verhielden;verhoude;verhoudt;
verbreiden===verbreiden;verbreid;verbreidde;verbreidden;verbreide;verbreidt;
praten===praten;praatten;prate;
afranselen===afranselen;afransel;afranselde;afranselden;afransele;afranselt;
afzwakken===afzwakken;
beschijnen===beschijnen;bescheen;beschene;beschenen;beschijn;beschijne;beschijnt;
borgen===borgen;borgden;borge;
intreden===intreden;intrade;intraden;intrede;intreed;
verlangzamen===verlangzamen;verlangzaam;verlangzaamde;verlangzaamden;verlangzaamt;verlangzame;
terugnemen===terugnemen;terugnam;terugname;terugnamen;terugneem;terugneemt;terugneme;
weten===weten;wete;
beetnemen===beetnemen;beetname;beetnamen;beetneem;beetneme;
mikken===mikken;mikke;mikten;
roven===roven;rove;
consolideren===consolideren;consolideer;consolideerde;consolideerden;consolideert;consolidere;
emmeren===emmeren;emmer;emmerde;emmerden;emmere;emmert;
vermissen===vermissen;vermisse;vermiste;vermisten;
bedienen===bedienen;bedien;bediende;bediene;bedient;
afluisteren===afluisteren;afluister;afluisterde;afluisterden;afluistere;afluistert;
rekken===rekken;rekke;rekten;
inschenken===inschenken;inschenk;inschenke;inschenkt;inschonk;inschonke;inschonken;inschonkt;
overmeesteren===overmeesteren;overmeester;overmeesterde;overmeesterden;overmeestere;overmeestert;
ontsteken===ontsteken;ontstake;ontstaken;ontsteek;ontsteke;
trachten===trachten;tracht;trachte;trachtte;trachtten;
toedichten===toedichten;toedicht;toedichte;toedichtte;toedichtten;
aantreden===aantreden;aantrade;aantraden;aantrede;aantreed;
projecteren===projecteren;projecteer;projecteerde;projecteerden;projecteert;projectere;
achterhalen===achterhalen;achterhaal;achterhaalde;achterhaalden;achterhaalt;achterhale;
induiken===induiken;indoken;induik;induike;induikt;
verlengen===verlengen;verleng;verlengde;verlengden;verlenge;verlengt;
kopiëren===kopiëren;kopieerden;kopiëre;
rechten===rechten;recht;rechte;rechtte;rechtten;
kortsluiten===kortsluiten;kortslote;kortsloten;kortsluit;kortsluite;
intikken===intikken;intikke;intikte;intikten;
schroeven===schroeven;schroefden;schroeve;
doorprikken===doorprikken;doorprik;doorprikke;doorprikt;doorprikte;doorprikten;
voorbereiden===voorbereiden;voorbereid;voorbereidde;voorbereidden;voorbereide;voorbereidt;
meedoen===meedoen;meededen;meedeed;meedoe;meedoet;
nippen===nippen;nippe;nipten;
drinken===drinken;drink;drinke;drinkt;dronke;dronken;
indenken===indenken;
ingaan===ingaan;ingaat;
verhangen===verhangen;verhang;verhange;verhangt;verhinge;verhingen;
samentrekken===samentrekken;samentrek;samentrekke;samentrekt;samentrokke;samentrokken;
stoven===stoven;stove;
stemmen===stemmen;stemde;stemden;stemme;
foeteren===foeteren;foeter;foeterde;foeterden;foetere;foetert;
verrassen===verrassen;verrasse;verraste;verrasten;
drukken===drukken;drukke;drukte;drukten;
bekennen===bekennen;bekende;bekenden;bekenne;
gamen===gamen;game;gameden;gamet;
federaliseren===federaliseren;federaliseer;federaliseerde;federaliseerden;federaliseert;federalisere;
aankunnen===aankunnen;aankonden;aankunne;
terugkeren===terugkeren;terugkeer;terugkeerde;terugkeerden;terugkeert;terugkere;
formeren===formeren;formeer;formeerden;formere;
gunnen===gunnen;gunden;gunne;
wiegen===wiegen;wiegden;wiege;
droogleggen===droogleggen;droogleg;drooglegde;drooglegden;drooglegge;drooglegt;
uitgooien===uitgooien;uitgooi;uitgooide;uitgooiden;uitgooie;uitgooit;
bebroeden===bebroeden;bebroed;bebroedde;bebroedden;bebroede;bebroedt;
opklimmen===opklimmen;opklimme;opklomme;opklommen;
tuigen===tuigen;tuigden;tuige;
reflecteren===reflecteren;reflecteer;reflecteerde;reflecteerden;reflecteert;reflectere;
afkomen===afkomen;afkom;afkome;afkomt;afkwamen;
aanhalen===aanhalen;aanhaalden;aanhale;
huilen===huilen;huilden;huile;
overstappen===overstappen;overstap;overstappe;overstapt;overstapte;overstapten;
plaatsen===plaatsen;plaats;plaatse;plaatst;plaatste;plaatsten;
nazeggen===nazeggen;nazegde;nazegden;nazegge;nazeiden;
pensioneren===pensioneren;pensioneer;pensioneerde;pensioneerden;pensioneert;pensionere;
folteren===folteren;folter;folterde;folterden;foltere;foltert;
drieken===drieken;
oplaaien===oplaaien;oplaai;oplaaide;oplaaiden;oplaaie;oplaait;
pauzeren===pauzeren;pauzeer;pauzeerden;pauzere;
heiligen===heiligen;heilig;heiligde;heiligden;heilige;heiligt;
poseren===poseren;poseer;poseerden;posere;
begroten===begroten;begrootten;begrote;
opereren===opereren;opereer;opereerden;operere;
uitwerken===uitwerken;uitwerk;uitwerke;uitwerkt;uitwerkte;uitwerkten;
inunderen===inunderen;inundeer;inundeerde;inundeerden;inundere;
afremmen===afremmen;afremde;afremden;afremme;
tonen===tonen;tone;toonden;
spatten===spatten;spatte;
verschuiven===verschuiven;verschove;verschoven;verschuif;verschuift;verschuive;
insmeren===insmeren;insmeer;insmeerden;insmere;
aanpappen===aanpappen;aanpappe;aanpapte;aanpapten;
neerslaan===neerslaan;neersla;neerslaat;
welken===welken;
verduren===verduren;verdure;verduurden;
baden===baden;baadden;bade;
betogen===betogen;betoge;betoogden;
schaven===schaven;schave;
verwijten===verwijten;verweten;verwijt;verwijte;
bejagen===bejagen;bejaagden;bejage;bejoegen;
balen===balen;baalden;bale;
ontheiligen===ontheiligen;
vermelden===vermelden;vermeld;vermeldde;vermeldden;vermelde;vermeldt;
faseren===faseren;faseer;faseerden;fasere;
bespioneren===bespioneren;bespioneer;bespioneerde;bespioneerden;bespioneert;bespionere;
stalken===stalken;stalk;stalke;stalkt;stalkte;stalkten;
inklokken===inklokken;inklokke;inklokte;inklokten;
verwarmen===verwarmen;verwarm;verwarmde;verwarmden;verwarme;verwarmt;
goochelen===goochelen;goochel;goochelde;goochelden;goochele;goochelt;
becijferen===becijferen;becijfer;becijferde;becijferden;becijfere;becijfert;
mogen===mogen;moge;
restaureren===restaureren;restaureer;restaureerde;restaureerden;restaureert;restaurere;
aaien===aaien;aaiden;aaie;
vervellen===vervellen;vervelde;vervelden;vervelle;
duiken===duiken;duike;
krabben===krabben;krabbe;krabde;krabden;
vouwen===vouwen;vouwden;vouwe;
antwoorden===antwoorden;antwoord;antwoordde;antwoordden;antwoorde;antwoordt;
paren===paren;paarden;pare;
langskomen===langskomen;langskom;langskome;langskomt;langskwame;langskwamen;
merken===merken;merke;merkten;
inslaan===inslaan;insla;inslaat;
aflopen===aflopen;afliepen;aflope;
wijden===wijden;wijdden;wijde;
vermijden===vermijden;vermeden;vermijd;vermijde;vermijdt;
verslikken===verslikken;verslik;verslikke;verslikt;verslikte;verslikten;
douchen===douchen;douch;douche;doucht;douchte;douchten;
bungelen===bungelen;bungel;bungelde;bungelden;bungele;bungelt;
aankleden===aankleden;aanklede;aankleed;aankleedde;aankleedden;
bijeenroepen===bijeenroepen;bijeenriep;bijeenriepe;bijeenriepen;bijeenriept;bijeenroep;bijeenroepe;bijeenroept;
roesten===roesten;roest;roeste;roestte;roestten;
bevelen===bevelen;bevale;bevalen;beveel;bevele;
verversen===verversen;ververs;ververse;ververst;ververste;verversten;
klutsen===klutsen;kluts;klutse;klutst;klutste;klutsten;
doorstaan===doorstaan;doorsta;doorstaat;
toosten===toosten;toost;tooste;toostte;toostten;
proesten===proesten;proest;proeste;proestte;proestten;
bedonderen===bedonderen;bedonder;bedonderde;bedonderden;bedondere;bedondert;
afscheiden===afscheiden;afscheid;afscheidde;afscheidden;afscheide;afscheidt;
overdekken===overdekken;overdek;overdekke;overdekt;overdekte;overdekten;
vermolmen===vermolmen;vermolm;vermolmde;vermolmden;vermolme;vermolmt;
veropenbaren===veropenbaren;veropenbaar;veropenbaarde;veropenbaarden;veropenbaart;veropenbare;
afronden===afronden;afrond;afrondde;afrondden;afronde;afrondt;
nemen===nemen;namen;neme;
tekenen===tekenen;teken;tekende;tekenden;tekene;tekent;
ophopen===ophopen;ophoopten;ophope;
prononceren===prononceren;prononceer;prononceerde;prononceerden;prononceert;prononcere;
berekenen===berekenen;bereken;berekende;berekenden;berekene;berekent;
verbeuzelen===verbeuzelen;verbeuzel;verbeuzelde;verbeuzelden;verbeuzele;verbeuzelt;
pokeren===pokeren;poker;pokerde;pokerden;pokere;pokert;
ingieten===ingieten;ingiet;ingiete;ingoten;
ondersteunen===ondersteunen;ondersteun;ondersteunde;ondersteunden;ondersteune;ondersteunt;
werpen===werpen;werpe;wierpen;
kallen===kallen;kalden;kalle;
instinken===instinken;instink;instinke;instinkt;instonke;instonken;
aanmelden===aanmelden;aanmeld;aanmeldde;aanmeldden;aanmelde;aanmeldt;
relateren===relateren;relateer;relateerde;relateerden;relatere;
dupliceren===dupliceren;dupliceer;dupliceerde;dupliceerden;dupliceert;duplicere;
vertikken===vertikken;vertikke;vertikte;vertikten;
vloeken===vloeken;vloek;vloeke;vloekt;vloekte;vloekten;
aborteren===aborteren;aborteer;aborteerde;aborteerden;abortere;
bevolken===bevolken;bevolk;bevolke;bevolkt;bevolkte;bevolkten;
opeenhopen===opeenhopen;opeenhoop;opeenhoopt;opeenhoopte;opeenhoopten;opeenhope;
uitgeven===uitgeven;uitgave;uitgaven;uitgeef;uitgeve;
slagen===slagen;slaagden;slage;
fecunderen===fecunderen;fecundeer;fecundeerde;fecundeerden;fecundeert;fecundere;
plagen===plagen;plaagden;plage;
beleven===beleven;beleef;beleve;
hinken===hinken;hinke;hinkten;
biepen===biepen;biepe;biepten;
afgeven===afgeven;afgave;afgaven;afgeef;afgeve;
uitvloeien===uitvloeien;uitvloei;uitvloeide;uitvloeiden;uitvloeie;uitvloeit;
huldigen===huldigen;huldig;huldigde;huldigden;huldige;huldigt;
smelten===smelten;smelt;smelte;smolte;smolten;
bevorderen===bevorderen;bevorder;bevorderde;bevorderden;bevordere;bevordert;
buigen===buigen;buige;
beweiden===beweiden;beweid;beweidde;beweidden;beweide;beweidt;
leiden===leiden;leidden;leide;
uitlokken===uitlokken;uitlokke;uitlokte;uitlokten;
wegzetten===wegzetten;wegzette;
afbuigen===afbuigen;afbogen;afbuig;afbuige;afbuigt;
remmen===remmen;remden;remme;
opluchten===opluchten;
overlopen===overlopen;overliepen;overlope;
evacueren===evacueren;evacueer;evacueerde;evacueerden;evacuere;
doordringen===doordringen;doordring;doordringe;doordringt;doordrong;doordronge;doordrongen;doordrongt;
meedelen===meedelen;mededelen;meedeel;meedeelden;meedele;
dateren===dateren;dateer;dateerden;datere;
ontwennen===ontwennen;ontwende;ontwenden;ontwenne;
ondernemen===ondernemen;ondernam;ondername;ondernamen;onderneem;onderneemt;onderneme;
toekennen===toekennen;toekende;toekenden;toekenne;
heten===heten;heetten;hete;
aankomen===aankomen;aankom;aankome;aankomt;aankwamen;
afdammen===afdammen;afdamde;afdamden;afdamme;
kruisen===kruisen;kruis;kruise;kruist;kruiste;kruisten;
moduleren===moduleren;moduleer;moduleerde;moduleerden;modulere;
schaden===schaden;schaadden;schade;
redeneren===redeneren;redeneer;redeneerde;redeneerden;redenere;
verrijken===verrijken;verrijk;verrijke;verrijkt;verrijkte;verrijkten;
eruitzien===eruitzien;
verwerken===verwerken;verwerk;verwerke;verwerkt;verwerkte;verwerkten;
opwekken===opwekken;opwekke;opwekte;opwekten;
achtervolgen===achtervolgen;achtervolg;achtervolgde;achtervolgden;achtervolge;achtervolgt;
boeten===boeten;boete;boetten;
transformeren===transformeren;transformeer;transformeerde;transformeerden;transformeert;transformere;
rekwireren===rekwireren;rekwireer;rekwireerde;rekwireerden;rekwireert;rekwirere;
verzinken===verzinken;verzink;verzinke;verzinkt;verzinkte;verzinkten;verzonke;verzonken;
lusten===lusten;luste;lustten;
uitstrekken===uitstrekken;uitstrek;uitstrekke;uitstrekt;uitstrekte;uitstrekten;
gieren===gieren;gierden;giere;
striemen===striemen;striem;striemde;striemden;strieme;striemt;
knielen===knielen;kniel;knielde;knielden;kniele;knielt;
compileren===compileren;compileer;compileerde;compileerden;compileert;compilere;
afruimen===afruimen;afruim;afruimde;afruimden;afruime;afruimt;
verwekken===verwekken;verwekke;verwekte;verwekten;
fotosoepen===fotosoepen;
stabiliseren===stabiliseren;stabiliseer;stabiliseerde;stabiliseerden;stabiliseert;stabilisere;
afjagen===afjagen;afjaagden;afjage;afjoegen;
terugzetten===terugzetten;terugzet;terugzette;
fotograferen===fotograferen;fotografeer;fotografeerde;fotografeerden;fotografeert;fotografere;
roemen===roemen;roemden;roeme;
lenen===lenen;leen;leenden;lene;
overheersen===overheersen;overheers;overheerse;overheerst;overheerste;overheersten;
uitzoeken===uitzoeken;uitzochten;uitzoek;uitzoeke;uitzoekt;
doen===doen;doe;doet;
aanmoedigen===aanmoedigen;aanmoedig;aanmoedigde;aanmoedigden;aanmoedige;aanmoedigt;
slijten===slijten;sleten;slijt;slijte;
effectueren===effectueren;effectueer;effectueerde;effectueerden;effectueert;effectuere;
schoppen===schoppen;schoppe;schopte;schopten;
scholen===scholen;schole;schoolden;
proclameren===proclameren;proclameer;proclameerde;proclameerden;proclameert;proclamere;
vervolgen===vervolgen;vervolg;vervolgde;vervolgden;vervolge;vervolgt;
bekronen===bekronen;bekrone;bekroon;bekroonden;
zeggen===zeggen;zegden;zegge;
ontruimen===ontruimen;ontruim;ontruimde;ontruimden;ontruime;ontruimt;
opfrissen===opfrissen;opfrisse;opfriste;opfristen;
wurgen===wurgen;wurgden;wurge;
kirren===kirren;kirden;kirre;
vorderen===vorderen;
blakeren===blakeren;blaker;blakerde;blakerden;blakere;blakert;
bepalen===bepalen;bepaalden;bepale;
regeren===regeren;regeer;regeerden;regere;
overtreden===overtreden;overtrad;overtrade;overtraden;overtrede;overtreed;overtreedt;
hellen===hellen;helden;helle;
snoeren===snoeren;snoer;snoerde;snoerden;snoere;snoert;
uitbuiten===uitbuiten;uitbuit;uitbuite;uitbuitte;uitbuitten;
spruiten===spruiten;sproten;spruit;spruite;
fixen===fixen;
ontrafelen===ontrafelen;ontrafel;ontrafelde;ontrafelden;ontrafele;ontrafelt;
stampen===stampen;stamp;stampe;stampt;stampte;stampten;
verdwalen===verdwalen;verdwaalde;verdwaalden;verdwale;
oxideren===oxideren;oxideer;oxideerden;oxidere;
oefenen===oefenen;oefen;oefende;oefenden;oefene;oefent;
destilleren===destilleren;
verontrusten===verontrusten;verontrust;verontruste;verontrustte;verontrustten;
ontkurken===ontkurken;ontkurk;ontkurke;ontkurkt;ontkurkte;ontkurkten;
luxeren===luxeren;luxeer;luxeerden;luxere;
verkommeren===verkommeren;verkommer;verkommerde;verkommerden;verkommere;verkommert;
herzien===herzien;herzagen;herzie;herziet;
begrenzen===begrenzen;begrensden;begrenze;
verwringen===verwringen;verwring;verwringe;verwringt;verwrong;verwronge;verwrongen;verwrongt;
overbelasten===overbelasten;overbelast;overbelaste;overbelastte;overbelastten;
storten===storten;stort;storte;stortte;stortten;
overspoelen===overspoelen;overspoel;overspoelde;overspoelden;overspoele;overspoelt;
spijkeren===spijkeren;spijker;spijkerde;spijkerden;spijkere;spijkert;
harsten===harsten;harst;harste;harstte;harstten;
bevestigen===bevestigen;bevestig;bevestigde;bevestigden;bevestige;bevestigt;
weghalen===weghalen;weghaalden;weghale;
delen===delen;deelden;dele;
verklappen===verklappen;verklap;verklappe;verklapt;verklapte;verklapten;
uitkeren===uitkeren;uitkeer;uitkeerden;uitkere;
knoeien===knoeien;knoei;knoeide;knoeiden;knoeie;knoeit;
verhitten===verhitten;verhitte;
retoucheren===retoucheren;retoucheer;retoucheerde;retoucheerden;retoucheert;retouchere;
kammen===kammen;kamden;kamme;
schudden===schudden;schudde;
zegelen===zegelen;zegel;zegelde;zegelden;zegele;zegelt;
integreren===integreren;integreer;integreerde;integreerden;integreert;integrere;
samenhangen===samenhangen;samenhang;samenhange;samenhangt;samenhing;samenhinge;samenhingen;samenhingt;
bezinnen===bezinnen;bezinne;bezonne;bezonnen;
zien===zien;zie;ziet;
onthouden===onthouden;onthielden;onthoud;onthoude;onthoudt;
aangorden===aangorden;aangord;aangordde;aangordden;aangorde;aangordt;
versomberen===versomberen;versomber;versomberde;versomberden;versombere;versombert;
concurreren===concurreren;concurreer;concurreerde;concurreerden;concurreert;concurrere;
blasfemeren===blasfemeren;blasfemeer;blasfemeerde;blasfemeerden;blasfemeert;blasfemere;
verspreiden===verspreiden;verspreid;verspreidde;verspreidden;verspreide;verspreidt;
verrotten===verrotten;verrotte;
verslapen===verslapen;verslape;versliepen;
lispelen===lispelen;lispel;lispelde;lispelden;lispele;lispelt;
omverwerpen===omverwerpen;omverwerp;omverwerpe;omverwerpt;omverwierp;omverwierpe;omverwierpen;omverwierpt;
verdraaien===verdraaien;verdraai;verdraaide;verdraaiden;verdraaie;verdraait;
verankeren===verankeren;veranker;verankerde;verankerden;verankere;verankert;
herladen===herladen;herlaadden;herlade;
verwijderen===verwijderen;verwijder;verwijderde;verwijderden;verwijdere;verwijdert;
duelleren===duelleren;duelleer;duelleerde;duelleerden;duellere;
gaan===gaan;gaat;
maaien===maaien;maaiden;maaie;
overweldigen===overweldigen;overweldig;overweldigde;overweldigden;overweldige;overweldigt;
strikken===strikken;strikke;strikte;strikten;
hoeven===hoeven;hoefden;hoeve;
omleiden===omleiden;omleid;omleidde;omleidden;omleide;omleidt;
profeteren===profeteren;profeteer;profeteerde;profeteerden;profeteert;profetere;
castreren===castreren;castreer;castreerde;castreerden;castrere;
liquideren===liquideren;liquideer;liquideerde;liquideerden;liquideert;liquidere;
investeren===investeren;investeer;investeerde;investeerden;investeert;investere;
rapen===rapen;raapten;rape;
benadrukken===benadrukken;benadruk;benadrukke;benadrukt;benadrukte;benadrukten;
vangen===vangen;vange;vingen;
strijken===strijken;streken;strijk;strijke;strijkt;
vermoeden===vermoeden;vermoed;vermoedde;vermoedden;vermoede;vermoedt;
opdonderen===opdonderen;opdonder;opdonderde;opdonderden;opdondere;opdondert;
concluderen===concluderen;concludeer;concludeerde;concludeerden;concludeert;concludere;
constitueren===constitueren;constitueer;constitueerde;constitueerden;constitueert;constituere;
afdrukken===afdrukken;afdrukke;afdrukte;afdrukten;
borstelen===borstelen;borstel;borstelde;borstelden;borstele;borstelt;
kwetsen===kwetsen;kwets;kwetse;kwetst;kwetste;kwetsten;
uitwijzen===uitwijzen;uitwezen;uitwijze;
philosopheren===philosopheren;
flippen===flippen;flippe;flipte;flipten;
besparen===besparen;bespaarden;bespare;
spinnen===spinnen;spinde;spinden;spinne;sponne;sponnen;
voordringen===voordringen;voordring;voordringe;voordringt;voordrong;voordronge;voordrongen;voordrongt;
opscheppen===opscheppen;opschep;opscheppe;opschept;opschepte;opschepten;
mangelen===mangelen;mangel;mangelde;mangelden;mangele;mangelt;
na-apen===na-apen;na-aapten;na-ape;
verfilmen===verfilmen;verfilm;verfilmde;verfilmden;verfilme;verfilmt;
accentueren===accentueren;accentueer;accentueerde;accentueerden;accentueert;accentuere;
zijn===zijn;zij;zijt;
hengelen===hengelen;hengel;hengelde;hengelden;hengele;hengelt;
stroomlijnen===stroomlijnen;stroomlijn;stroomlijnde;stroomlijnden;stroomlijne;stroomlijnt;
ontwaken===ontwaken;ontwaakten;ontwake;
uitspoelen===uitspoelen;uitspoel;uitspoelde;uitspoelden;uitspoele;uitspoelt;
verengelsen===verengelsen;verengels;verengelse;verengelst;verengelste;verengelsten;
bijbrengen===bijbrengen;bijbreng;bijbrenge;bijbrengt;
masseren===masseren;masseer;masseerden;massere;
zetelen===zetelen;zetel;zetelde;zetelden;zetele;zetelt;
loven===loven;love;
reconstrueren===reconstrueren;reconstrueer;reconstrueerde;reconstrueerden;reconstrueert;reconstruere;
bestralen===bestralen;bestraalde;bestraalden;bestrale;
erbarmen===erbarmen;erbarm;erbarmde;erbarmden;erbarme;erbarmt;
verslijten===verslijten;verslete;versleten;verslijt;verslijte;
kronkelen===kronkelen;kronkel;kronkelde;kronkelden;kronkele;kronkelt;
verhapstukken===verhapstukken;verhapstuk;verhapstukke;verhapstukt;verhapstukte;verhapstukten;
genieten===genieten;geniet;geniete;genoten;
polariseren===polariseren;polariseer;polariseerde;polariseerden;polariseert;polarisere;
kankeren===kankeren;kanker;kankerde;kankerden;kankere;kankert;
opbouwen===opbouwen;opbouw;opbouwde;opbouwden;opbouwe;opbouwt;
verminderen===verminderen;verminder;verminderde;verminderden;vermindere;vermindert;
leggen===leggen;legden;legge;
voortplanten===voortplanten;voortplant;voortplante;voortplantte;voortplantten;
doordenken===doordenken;doordenk;doordenke;doordenkt;
winnen===winnen;winne;wonnen;
vermommen===vermommen;vermomde;vermomden;vermomme;
dirigeren===dirigeren;dirigeer;dirigeerde;dirigeerden;dirigere;
voorwenden===voorwenden;voorwend;voorwendde;voorwendden;voorwende;voorwendt;
aantonen===aantonen;aantone;aantoon;aantoonden;
porren===porren;porden;porre;
zinken===zinken;zinke;zonken;
opletten===opletten;oplette;
onterven===onterven;onterfden;onterve;
indrukken===indrukken;indrukke;indrukte;indrukten;
aanbelanden===aanbelanden;aanbeland;aanbelandde;aanbelandden;aanbelande;aanbelandt;
beven===beven;beve;
zonnebaden===zonnebaden;zonnebaad;zonnebaadde;zonnebaadden;zonnebaadt;zonnebade;
stiften===stiften;stift;stifte;stiftte;stiftten;
postuleren===postuleren;postuleer;postuleerde;postuleerden;postuleert;postulere;
dineren===dineren;dineer;dineerden;dinere;
afstoffen===afstoffen;afstoffe;afstofte;afstoften;
groeien===groeien;groei;groeide;groeiden;groeie;groeit;
begunstigen===begunstigen;begunstig;begunstigde;begunstigden;begunstige;begunstigt;
ontnemen===ontnemen;ontname;ontnamen;ontneem;ontneme;
wroegen===wroegen;wroeg;wroegde;wroegden;wroegt;
graven===graven;grave;groeven;
beheren===beheren;beheer;beheerden;behere;
benen===benen;been;beenden;bene;
ophemelen===ophemelen;ophemel;ophemelde;ophemelden;ophemele;ophemelt;
harken===harken;harke;harkten;
aanrijden===aanrijden;aanreden;aanrijd;aanrijde;aanrijdt;
verzaken===verzaken;verzaakten;verzake;
herstarten===herstarten;herstart;herstarte;herstartte;herstartten;
briesen===briesen;bries;briese;briest;brieste;briesten;
pasen===pasen;paasten;pase;
toedenken===toedenken;toedenk;toedenke;toedenkt;
afstammen===afstammen;afstamde;afstamden;afstamme;
schokken===schokken;schokke;schokte;schokten;
ontmoeten===ontmoeten;ontmoet;ontmoete;ontmoette;ontmoetten;
voeden===voeden;voedden;voede;
brouwen===brouwen;brouw;brouwde;brouwden;brouwe;brouwt;
vergieten===vergieten;vergiet;vergiete;vergoten;
inlassen===inlassen;inlasse;inlaste;inlasten;
worden===worden;werden;worde;
begraven===begraven;begrave;begroeven;
graaien===graaien;
doorvoeren===doorvoeren;doorvoer;doorvoerde;doorvoerden;doorvoere;doorvoert;
bespringen===bespringen;bespring;bespringe;bespringt;besprong;bespronge;besprongen;besprongt;
slingeren===slingeren;slinger;slingerde;slingerden;slingere;slingert;
overkomen===overkomen;overkom;overkome;overkomt;overkwamen;
omarmen===omarmen;omarm;omarmde;omarmden;omarme;omarmt;
kamperen===kamperen;kampeer;kampeerden;kampere;
knijpen===knijpen;knepen;knijp;knijpe;knijpt;
aanschouwen===aanschouwen;aanschouw;aanschouwde;aanschouwden;aanschouwe;aanschouwt;
vluchten===vluchten;vlucht;vluchte;vluchtte;vluchtten;
laven===laven;
doorwerken===doorwerken;doorwerk;doorwerke;doorwerkt;doorwerkte;doorwerkten;
puncteren===puncteren;puncteer;puncteerde;puncteerden;punctere;
eten===eten;aten;ete;
puffen===puffen;puffe;puften;
lachen===lachen;lache;lachten;
vloeren===vloeren;vloer;vloerde;vloerden;vloere;vloert;
verblijven===verblijven;verbleve;verbleven;verblijf;verblijft;verblijve;
beplaten===beplaten;beplaatten;beplate;
aanvechten===aanvechten;aanvecht;aanvechte;aanvocht;aanvochte;aanvochten;
beredeneren===beredeneren;beredeneer;beredeneerde;beredeneerden;beredeneert;beredenere;
schreeuwen===schreeuwen;schreeuw;schreeuwde;schreeuwden;schreeuwe;schreeuwt;
vernederlandsen===vernederlandsen;vernederlands;vernederlandse;vernederlandst;vernederlandste;vernederlandsten;
schallen===schallen;schalde;schalden;schalle;
waren===waren;waarden;ware;
kopen===kopen;kope;
troosten===troosten;troost;trooste;troostte;troostten;
detecteren===detecteren;detecteer;detecteerde;detecteerden;detecteert;detectere;
beduvelen===beduvelen;beduvel;beduvelde;beduvelden;beduvele;beduvelt;
samenleven===samenleven;samenleef;samenleefden;samenleeft;samenleve;
strooien===strooien;strooi;strooide;strooiden;strooie;strooit;
intrappen===intrappen;intrappe;intrapte;intrapten;
dichtdoen===dichtdoen;dichtdeden;dichtdeed;dichtdeedt;dichtdoe;dichtdoet;
tölten===tölten;tölte;töltten;
arroseren===arroseren;arroseer;arroseerde;arroseerden;arrosere;
uitwijken===uitwijken;uitweken;uitwijk;uitwijke;uitwijkt;
gijzelen===gijzelen;gijzel;gijzelde;gijzelden;gijzele;gijzelt;
overtreffen===overtreffen;overtref;overtreffe;overtreft;overtroffe;overtroffen;
verwennen===verwennen;verwende;verwenden;verwenne;
eisen===eisen;eise;eisten;
toeslaan===toeslaan;toesla;toeslaat;
zomeren===zomeren;zomer;zomerde;zomerden;zomere;zomert;
kluiven===kluiven;kloven;kluive;
waarschuwen===waarschuwen;waarschuw;waarschuwde;waarschuwden;waarschuwe;waarschuwt;
zweren===zweren;zweerden;zwere;zwoeren;zworen;
noemen===noemen;noemden;noeme;
uitsteken===uitsteken;uitstake;uitstaken;uitsteek;uitsteke;
glooien===glooien;glooi;glooide;glooiden;glooie;glooit;
wentelen===wentelen;wentel;wentelde;wentelden;wentele;wentelt;
hokken===hokken;hokke;hokten;
bemannen===bemannen;bemande;bemanden;bemanne;
flikken===flikken;flikke;flikte;flikten;
opkomen===opkomen;opkom;opkome;opkomt;opkwamen;
terugsturen===terugsturen;terugsture;terugstuur;terugstuurde;terugstuurden;terugstuurt;
draaien===draaien;draai;draaide;draaiden;draaie;draait;
grendelen===grendelen;grendel;grendelde;grendelden;grendele;grendelt;
opschudden===opschudden;opschud;opschudde;opschude;opschuden;opschudt;
slaan===slaan;slaat;
ontwateren===ontwateren;ontwater;ontwaterde;ontwaterden;ontwatere;ontwatert;
neerkijken===neerkijken;neerkeke;neerkeken;neerkijk;neerkijke;neerkijkt;
benaderen===benaderen;benader;benaderde;benaderden;benadere;benadert;
bekommeren===bekommeren;bekommer;bekommerde;bekommerden;bekommere;bekommert;
cirkelen===cirkelen;cirkel;cirkelde;cirkelden;cirkele;cirkelt;
teloorgaan===teloorgaan;teloorga;teloorgaat;teloorging;
bergen===bergen;berge;borgen;
ijken===ijken;ijke;ijkten;
toelopen===toelopen;toeliepen;toelope;
gassen===gassen;gasse;gasten;
detacheren===detacheren;detacheer;detacheerde;detacheerden;detacheert;detachere;
ontstellen===ontstellen;ontstel;ontstelde;ontstelden;ontstelle;ontstelt;
zwoegen===zwoegen;zwoeg;zwoegde;zwoegden;zwoege;zwoegt;
herinterviewen===herinterviewen;herinterview;herinterviewde;herinterviewden;herinterviewe;herinterviewt;
terugzien===terugzien;terugzagen;terugzie;terugziet;
begeleiden===begeleiden;begeleid;begeleidde;begeleidden;begeleide;begeleidt;
opwinden===opwinden;opwind;opwinde;opwindt;opwonde;opwonden;
afdingen===afdingen;afding;afdinge;afdingt;afdonge;afdongen;
klaarkomen===klaarkomen;klaarkom;klaarkome;klaarkomt;klaarkwame;klaarkwamen;
schamen===schamen;schaamden;schame;
stellen===stellen;stelde;stelden;stelle;
berispen===berispen;berisp;berispe;berispt;berispte;berispten;
verbieden===verbieden;verbied;verbiede;verbiedt;verboden;
oprapen===oprapen;opraapten;oprape;
samendrukken===samendrukken;samendruk;samendrukke;samendrukt;samendrukte;samendrukten;
spotten===spotten;
waarderen===waarderen;waardeer;waardeerde;waardeerden;waardere;
reiken===reiken;reike;reikten;
propageren===propageren;propageer;propageerde;propageerden;propageert;propagere;
tinten===tinten;tinte;tintten;
gonzen===gonzen;gonsden;gonze;
opstaan===opstaan;opsta;opstaat;
fixeren===fixeren;fixeer;fixeerden;fixere;
sturen===sturen;sture;stuurden;
zeven===zeven;zeve;
fiksen===fiksen;fikse;fiksten;
verkondigen===verkondigen;verkondig;verkondigde;verkondigden;verkondige;verkondigt;
onderlopen===onderlopen;onderliep;onderliepe;onderliepen;onderloop;onderloopt;onderlope;
traceren===traceren;traceer;traceerden;tracere;
verhalen===verhalen;verhaalden;verhale;
harden===harden;hardden;harde;
behoeden===behoeden;behoed;behoedde;behoedden;behoede;behoedt;
helen===helen;heelden;hele;
documenteren===documenteren;documenteer;documenteerde;documenteerden;documenteert;documentere;
klooien===klooien;klooi;klooide;klooiden;klooie;klooit;
volgen===volgen;volgden;volge;
kerven===kerven;kerfden;kerve;korven;
isoleren===isoleren;isoleer;isoleerden;isolere;
behandelen===behandelen;behandel;behandelde;behandelden;behandele;behandelt;
resteren===resteren;resteer;resteerden;restere;
klemmen===klemmen;klemde;klemden;klemme;
kaatsen===kaatsen;kaats;kaatse;kaatst;kaatste;kaatsten;
toedienen===toedienen;toedien;toediende;toedienden;toediene;toedient;
rehabiliteren===rehabiliteren;rehabiliteer;rehabiliteerde;rehabiliteerden;rehabiliteert;rehabilitere;
geraken===geraken;geraakten;gerake;
uitglijden===uitglijden;uitglede;uitgleden;uitglijd;uitglijde;uitglijdt;
verdonkeremanen===verdonkeremanen;
plotten===plotten;plotte;
aanvaarden===aanvaarden;aanvaard;aanvaardde;aanvaardden;aanvaarde;aanvaardt;
knarsen===knarsen;knars;knarse;knarst;knarste;knarsten;
kermen===kermen;kermden;kerme;
terugstellen===terugstellen;terugstel;terugstelde;terugstelden;terugstelle;terugstelt;
verstuiken===verstuiken;verstuik;verstuike;verstuikt;verstuikte;verstuikten;
ryden===ryden;
afdalen===afdalen;afdaalden;afdale;
schikken===schikken;schikke;schikte;schikten;
omvallen===omvallen;omvalle;omvielen;
fonkelen===fonkelen;fonkel;fonkelde;fonkelden;fonkele;fonkelt;
opdoen===opdoen;opdeden;opdoe;opdoet;
aandrijven===aandrijven;aandreve;aandreven;aandrijf;aandrijft;aandrijve;
uitvaardigen===uitvaardigen;uitvaardig;uitvaardigde;uitvaardigden;uitvaardige;uitvaardigt;
deprimeren===deprimeren;deprimeer;deprimeerde;deprimeerden;deprimeert;deprimere;
samenvoegen===samenvoegen;samenvoeg;samenvoegde;samenvoegden;samenvoege;samenvoegt;
plegen===plegen;pleegden;plege;
overeten===overeten;overate;overaten;overeet;overete;
vasten===vasten;vaste;vastten;
sabbelen===sabbelen;sabbel;sabbelde;sabbelden;sabbele;sabbelt;
scherpen===scherpen;scherp;scherpe;scherpt;scherpte;scherpten;
beschouwen===beschouwen;beschouw;beschouwde;beschouwden;beschouwe;beschouwt;
verzorgen===verzorgen;verzorg;verzorgde;verzorgden;verzorge;verzorgt;
blesseren===blesseren;blesseer;blesseerde;blesseerden;blessere;
weggaan===weggaan;wegga;weggaat;
oprijzen===oprijzen;oprezen;oprijze;
smaden===smaden;smaadden;smade;
onttrekken===onttrekken;onttrek;onttrekke;onttrekt;onttrokke;onttrokken;
verenigen===verenigen;verenig;verenigde;verenigden;verenige;verenigt;
modificeren===modificeren;modificeer;modificeerde;modificeerden;modificeert;modificere;
tegenhouden===tegenhouden;tegenhielden;tegenhou;tegenhoud;tegenhoude;tegenhoudt;
fikken===fikken;fikke;fikten;
strippen===strippen;strippe;stripte;stripten;
bouwen===bouwen;bouwden;bouwe;
terughalen===terughalen;terughaal;terughaalde;terughaalden;terughaalt;terughale;
weerleggen===weerleggen;weerleg;weerlegde;weerlegden;weerlegge;weerlegt;
volproppen===volproppen;volprop;volproppe;volpropt;volpropte;volpropten;
behagen===behagen;behaagden;behage;
verkleden===verkleden;verklede;verkleed;verkleedde;verkleedden;
blikken===blikken;blikke;blikte;blikten;
terechtstellen===terechtstellen;terechtstel;terechtstelde;terechtstelden;terechtstelle;terechtstelt;
bevreemden===bevreemden;bevreemd;bevreemdde;bevreemdden;bevreemde;bevreemdt;
ogen===ogen;oge;
distilleren===distilleren;distilleer;distilleerde;distilleerden;distilleert;distillere;
verkorten===verkorten;verkort;verkorte;verkortte;verkortten;
opprimeren===opprimeren;opprimeer;opprimeerde;opprimeerden;opprimeert;opprimere;
dralen===dralen;draalden;drale;
oscilleren===oscilleren;oscilleer;oscilleerde;oscilleerden;oscilleert;oscillere;
vrijspreken===vrijspreken;vrijsprak;vrijsprake;vrijspraken;vrijspreek;vrijspreekt;vrijspreke;
onderdompelen===onderdompelen;onderdompel;onderdompelde;onderdompelden;onderdompele;onderdompelt;
uitstellen===uitstellen;uitstel;uitstelde;uitstelden;uitstelle;uitstelt;
aanmaken===aanmaken;aanmaakten;aanmake;
opeten===opeten;opaten;opete;
doorgeven===doorgeven;doorgave;doorgaven;doorgeef;doorgeve;
inspreken===inspreken;insprake;inspraken;inspreek;inspreke;
aankondigen===aankondigen;aankondig;aankondigde;aankondigden;aankondige;aankondigt;
rollebollen===rollebollen;rollebol;rollebolde;rollebolden;rollebolle;rollebolt;
schuilen===schuilen;scholen;schuil;schuile;schuilt;
scanderen===scanderen;scandeer;scandeerde;scandeerden;scandere;
deporteren===deporteren;deporteer;deporteerde;deporteerden;deporteert;deportere;
motiveren===motiveren;motiveer;motiveerde;motiveerden;motivere;
refuteren===refuteren;refuteer;refuteerde;refuteerden;refutere;
keuren===keuren;keurden;keure;
verbazen===verbazen;verbaasden;verbaze;
winkelen===winkelen;winkel;winkelde;winkelden;winkele;winkelt;
tolereren===tolereren;tolereer;tolereerde;tolereerden;tolerere;
peuteren===peuteren;peuter;peuterde;peuterden;peutere;peutert;
grijnzen===grijnzen;grijnsden;grijnze;
wapperen===wapperen;wapper;wapperde;wapperden;wappere;wappert;
blokken===blokken;blokke;blokte;blokten;
aanhangen===aanhangen;aanhang;aanhange;aanhangt;aanhinge;aanhingen;
brandstichten===brandstichten;brandsticht;brandstichte;brandstichtte;brandstichtten;
schrappen===schrappen;schrappe;schrapte;schrapten;
uitloven===uitloven;uitloofden;uitlove;
koken===koken;koke;kookten;
doortrekken===doortrekken;
afwerken===afwerken;afwerk;afwerke;afwerkt;afwerkte;afwerkten;
versieren===versieren;versier;versierde;versierden;versiere;versiert;
afvragen===afvragen;afvraagden;afvrage;afvroegen;
casten===casten;caste;castten;
toewijzen===toewijzen;toewezen;toewijze;
decoderen===decoderen;decodeer;decodeerde;decodeerden;decodere;
inhuren===inhuren;
dwingen===dwingen;dwing;dwinge;dwingt;dwonge;dwongen;
popelen===popelen;
verzegelen===verzegelen;verzegel;verzegelde;verzegelden;verzegele;verzegelt;
krijgen===krijgen;kregen;krijg;krijge;krijgt;
omringen===omringen;omring;omringde;omringden;omringe;omringt;
beschermen===beschermen;bescherm;beschermde;beschermden;bescherme;beschermt;
vertroosten===vertroosten;
tokkelen===tokkelen;tokkel;tokkelde;tokkelden;tokkele;tokkelt;
opzienbaren===opzienbaren;
omzomen===omzomen;omzome;omzoomden;
uitzetten===uitzetten;uitzette;
neerdalen===neerdalen;nederdalen;neerdaalde;neerdaalden;neerdale;
maren===maren;maarden;mare;
hertrouwen===hertrouwen;hertrouw;hertrouwde;hertrouwden;hertrouwe;hertrouwt;
constateren===constateren;constateer;constateerde;constateerden;constateert;constatere;
oorvegen===oorvegen;oorveeg;oorveegden;oorvege;
uitbraken===uitbraken;uitbraakte;uitbraakten;uitbrake;
verwelken===verwelken;verwelk;verwelke;verwelkt;verwelkte;verwelkten;
sissen===sissen;sisse;sisten;
tasten===tasten;taste;tastten;
plukken===plukken;plukke;plukte;plukten;
ballen===ballen;balden;balle;
kastijden===kastijden;
collectiviseren===collectiviseren;collectiviseer;collectiviseerde;collectiviseerden;collectiviseert;collectivisere;
ejaculeren===ejaculeren;ejaculeer;ejaculeerde;ejaculeerden;ejaculeert;ejaculere;
conjugeren===conjugeren;conjugeer;conjugeerde;conjugeerden;conjugeert;conjugere;
uitdragen===uitdragen;uitdrage;uitdroegen;
bevochtigen===bevochtigen;bevochtig;bevochtigde;bevochtigden;bevochtige;bevochtigt;
vertoeven===vertoeven;vertoefden;vertoeve;
vliegen===vliegen;vlieg;vliege;vliegt;vlogen;
slaapwandelen===slaapwandelen;slaapwandel;slaapwandelde;slaapwandelden;slaapwandele;slaapwandelt;
spoken===spoken;spoke;spookten;
toetreden===toetreden;toetrade;toetraden;toetrede;toetreed;
comprimeren===comprimeren;comprimeer;comprimeerde;comprimeerden;comprimeert;comprimere;
spammen===spammen;spamde;spamden;spamme;
kicken===kicken;kicke;kickten;
nieten===nieten;niete;nietten;
voorbijgaan===voorbijgaan;voorbijga;voorbijgaat;voorbijging;
bedelven===bedelven;bedelve;bedolve;bedolven;
doorschakelen===doorschakelen;doorschakel;doorschakelde;doorschakelden;doorschakele;doorschakelt;
invallen===invallen;invalle;invielen;
discussiëren===discussiëren;discussieer;discussieerden;discussiëre;
bovenhalen===bovenhalen;bovenhaal;bovenhaalde;bovenhaalden;bovenhaalt;bovenhale;
wippen===wippen;wippe;wipten;
jodelen===jodelen;jodel;jodelde;jodelden;jodele;jodelt;
inchecken===inchecken;incheck;inchecke;incheckt;incheckte;incheckten;
poppen===poppen;poppe;popten;
bevrijden===bevrijden;bevrijd;bevrijdde;bevrijdden;bevrijde;bevrijdt;
prolongeren===prolongeren;prolongeer;prolongeerde;prolongeerden;prolongeert;prolongere;
wassen===wassen;wasse;wasten;
omschrijven===omschrijven;omschreve;omschreven;omschrijf;omschrijft;omschrijve;
penetreren===penetreren;penetreer;penetreerde;penetreerden;penetreert;penetrere;
neerzien===neerzien;neerzagen;neerzie;neerziet;
exerceren===exerceren;exerceer;exerceerde;exerceerden;exercere;
brengen===brengen;breng;brenge;brengt;
trainen===trainen;train;trainde;trainden;traine;traint;
botten===botten;butten;
bedingen===bedingen;beding;bedinge;bedingt;bedonge;bedongen;
pikken===pikken;pikke;pikten;
bekomen===bekomen;bekom;bekome;bekomt;bekwamen;
verkeren===verkeren;verkeer;verkeerden;verkere;
bakkeleien===bakkeleien;bakkelei;bakkeleide;bakkeleiden;bakkeleie;bakkeleit;
aanrekenen===aanrekenen;aanreken;aanrekende;aanrekenden;aanrekene;aanrekent;
aanprijzen===aanprijzen;aanpreze;aanprezen;aanprijs;aanprijst;aanprijze;
verschalken===verschalken;verschalk;verschalke;verschalkt;verschalkte;verschalkten;
hameren===hameren;hamer;hamerde;hamerden;hamere;hamert;
ontbreken===ontbreken;ontbrake;ontbraken;ontbreek;ontbreke;
inzenden===inzenden;inzend;inzende;inzendt;inzonde;inzonden;
suggereren===suggereren;suggereer;suggereerde;suggereerden;suggereert;suggerere;
boeien===boeien;boeiden;boeie;
reden===reden;rede;reedden;
spuwen===spuwen;spuwden;spuwe;
formuleren===formuleren;formuleer;formuleerde;formuleerden;formuleert;formulere;
afslanken===afslanken;afslank;afslanke;afslankt;afslankte;afslankten;
ondergraven===ondergraven;ondergraaf;ondergraaft;ondergrave;ondergroef;ondergroeve;ondergroeven;
uitrukken===uitrukken;uitrukke;uitrukte;uitrukten;
snurken===snurken;snurk;snurke;snurkt;snurkte;snurkten;
situeren===situeren;situeer;situeerden;situere;
struikelen===struikelen;struikel;struikelde;struikelden;struikele;struikelt;
uitslapen===uitslapen;uitslape;uitsliepen;
aftaaien===aftaaien;aftaai;aftaaide;aftaaiden;aftaaie;aftaait;
afkondigen===afkondigen;afkondig;afkondigde;afkondigden;afkondige;afkondigt;
hunkeren===hunkeren;hunker;hunkerde;hunkerden;hunkere;hunkert;
kosten===kosten;koste;kostten;
ontgassen===ontgassen;ontgasse;ontgaste;ontgasten;
spuien===spuien;spuiden;spuie;
identificeren===identificeren;identificeer;identificeerde;identificeerden;identificeert;identificere;
nastreven===nastreven;nastreef;nastreefden;nastreve;
vossen===vossen;vosse;vosten;
muilkorven===muilkorven;muilkorf;muilkorfde;muilkorfden;muilkorft;muilkorve;
kraaien===kraaien;kraai;kraaide;kraaiden;kraaie;kraait;
aanvoeren===aanvoeren;aanvoer;aanvoerde;aanvoerden;aanvoere;aanvoert;
verstaan===verstaan;versta;verstaat;
trimmen===trimmen;trimde;trimden;trimme;
detineren===detineren;detineer;detineerde;detineerden;detinere;
platbranden===platbranden;platbrand;platbrandde;platbrandden;platbrande;platbrandt;
achteropkomen===achteropkomen;achteropkom;achteropkome;achteropkomt;achteropkwame;achteropkwamen;
overbieden===overbieden;overbied;overbiede;overbiedt;overbode;overboden;
afzenden===afzenden;afzend;afzende;afzendt;afzonde;afzonden;
foerageren===foerageren;foerageer;foerageerde;foerageerden;foerageert;foeragere;
verwerven===verwerven;verwerve;verwierve;verwierven;
bijeenhouden===bijeenhouden;bijeenhielden;bijeenhou;bijeenhoud;bijeenhoude;bijeenhoudt;
verwoesten===verwoesten;verwoest;verwoeste;verwoestte;verwoestten;
inbakeren===inbakeren;inbaker;inbakerde;inbakerden;inbakere;inbakert;
bewaren===bewaren;bewaarden;beware;
zullen===zullen;zulle;
toetsen===toetsen;toets;toetse;toetst;toetste;toetsten;
schetsen===schetsen;schets;schetse;schetst;schetste;schetsten;
boren===boren;boorden;bore;
verbouwen===verbouwen;verbouw;verbouwde;verbouwden;verbouwe;verbouwt;
doodbliksemen===doodbliksemen;
betreffen===betreffen;betreffe;betroffe;betroffen;
nadenken===nadenken;nadenk;nadenke;nadenkt;
prediken===prediken;predik;predike;predikt;predikte;predikten;
afhaken===afhaken;afhaakten;afhake;
schertsen===schertsen;scherts;schertse;schertst;schertste;schertsten;
zaaien===zaaien;zaaiden;zaaie;
beschutten===beschutten;
hongeren===hongeren;honger;hongerde;hongerden;hongere;hongert;
executeren===executeren;executeer;executeerde;executeerden;executeert;executere;
ontvoeren===ontvoeren;ontvoer;ontvoerde;ontvoerden;ontvoere;ontvoert;
schoeien===schoeien;schoei;schoeide;schoeiden;schoeie;schoeit;
titreren===titreren;titreer;titreerden;titrere;
wandelen===wandelen;wandel;wandelde;wandelden;wandele;wandelt;
inschakelen===inschakelen;inschakel;inschakelde;inschakelden;inschakele;inschakelt;
stimuleren===stimuleren;stimuleer;stimuleerde;stimuleerden;stimuleert;stimulere;
plaveien===plaveien;plavei;plaveide;plaveiden;plaveie;plaveit;
treffen===treffen;treffe;troffe;troffen;
uitslijpen===uitslijpen;uitslepe;uitslepen;uitslijp;uitslijpe;uitslijpt;
kakken===kakken;kakke;kakten;
eroderen===eroderen;
marcheren===marcheren;marcheer;marcheerde;marcheerden;marchere;
fniezen===fniezen;
afdrogen===afdrogen;afdroge;afdroogden;
likken===likken;likke;likten;
kloppen===kloppen;kloppe;klopte;klopten;
trekken===trekken;trekke;trokke;trokken;
waken===waken;waakten;wake;
wonden===wonden;wondden;wonde;
blijven===blijven;bleven;blijve;
bestemmen===bestemmen;bestemde;bestemden;bestemme;
oplichten===oplichten;oplicht;oplichte;oplichtte;oplichtten;
zwabberen===zwabberen;zwabber;zwabberde;zwabberden;zwabbere;zwabbert;
verstikken===verstikken;verstik;verstikke;verstikt;verstikte;verstikten;
vervalsen===vervalsen;vervals;vervalse;vervalst;vervalste;vervalsten;
romantiseren===romantiseren;romantiseer;romantiseerde;romantiseerden;romantiseert;romantisere;
ophalen===ophalen;ophaalden;ophale;
wankelen===wankelen;wankel;wankelde;wankelden;wankele;wankelt;
verschrijven===verschrijven;verschreve;verschreven;verschrijf;verschrijft;verschrijve;
vergroeien===vergroeien;vergroei;vergroeide;vergroeiden;vergroeie;vergroeit;
lostrekken===lostrekken;lostrek;lostrekke;lostrekt;lostrokke;lostrokken;
meetronen===meetronen;meetrone;meetroon;meetroonde;meetroonden;
versnellen===versnellen;versnel;versnelde;versnelden;versnelle;versnelt;
reizen===reizen;reisden;reize;
verbitteren===verbitteren;verbitter;verbitterde;verbitterden;verbittere;verbittert;
vergeven===vergeven;vergave;vergaven;vergeef;vergeve;
onderscheiden===onderscheiden;onderscheid;onderscheidde;onderscheidden;onderscheide;onderscheidt;
begroeien===begroeien;begroei;begroeide;begroeiden;begroeie;begroeit;
grazen===grazen;graze;
opvissen===opvissen;opvisse;opviste;opvisten;
hoesten===hoesten;hoest;hoeste;hoestte;hoestten;
sommeren===sommeren;sommeer;sommeerden;sommere;
verzoenen===verzoenen;verzoen;verzoende;verzoenden;verzoene;verzoent;
verwijzen===verwijzen;verwezen;verwijze;
accelereren===accelereren;accelereer;accelereerde;accelereerden;accelereert;accelerere;
terugkaatsen===terugkaatsen;terugkaats;terugkaatse;terugkaatst;terugkaatste;terugkaatsten;
prikkelen===prikkelen;prikkel;prikkelde;prikkelden;prikkele;prikkelt;
verklikken===verklikken;verklik;verklikke;verklikt;verklikte;verklikten;
inwerpen===inwerpen;inwerp;inwerpe;inwerpt;inwierpe;inwierpen;
typeren===typeren;typeer;typeerden;typere;
betuigen===betuigen;betuig;betuigde;betuigden;betuige;betuigt;
toeschrijven===toeschrijven;toeschreve;toeschreven;toeschrijf;toeschrijft;toeschrijve;
voorbijkomen===voorbijkomen;voorbijkom;voorbijkome;voorbijkomt;voorbijkwame;voorbijkwamen;
verfraaien===verfraaien;verfraai;verfraaide;verfraaiden;verfraaie;verfraait;
chanteren===chanteren;chanteer;chanteerde;chanteerden;chantere;
belagen===belagen;belaagden;belage;
vergaderen===vergaderen;vergader;vergaderde;vergaderden;vergadere;vergadert;
tussenkomen===tussenkomen;tussenkom;tussenkome;tussenkomt;tussenkwame;tussenkwamen;
volharden===volharden;volhard;volhardde;volhardden;volharde;volhardt;
overvallen===overvallen;overval;overvalle;overvalt;overviele;overvielen;
roeien===roeien;roeiden;roeie;
bejubelen===bejubelen;bejubel;bejubelde;bejubelden;bejubele;bejubelt;
snacken===snacken;snack;snacke;snackt;snackte;snackten;
overschakelen===overschakelen;overschakel;overschakelde;overschakelden;overschakele;overschakelt;
herbouwen===herbouwen;herbouw;herbouwde;herbouwden;herbouwe;herbouwt;
uitvinden===uitvinden;uitvind;uitvinde;uitvindt;uitvonde;uitvonden;
schorsen===schorsen;schors;schorse;schorst;schorste;schorsten;
fladderen===fladderen;fladder;fladderde;fladderden;fladdere;fladdert;
personaliseren===personaliseren;personaliseer;personaliseerde;personaliseerden;personaliseert;personalisere;
afdwingen===afdwingen;afdwing;afdwinge;afdwingt;afdwonge;afdwongen;
betonen===betonen;betone;betoon;betoonden;
verbasteren===verbasteren;verbaster;verbasterde;verbasterden;verbastere;verbastert;
koeren===koeren;koerden;koere;
doorspoelen===doorspoelen;doorspoel;doorspoelde;doorspoelden;doorspoele;doorspoelt;
ontaarden===ontaarden;ontaard;ontaardde;ontaardden;ontaarde;ontaardt;
ankeren===ankeren;anker;ankerde;ankerden;ankere;ankert;
pekelen===pekelen;pekel;pekelde;pekelden;pekele;pekelt;
friemelen===friemelen;friemel;friemelde;friemelden;friemele;friemelt;
verdampen===verdampen;verdamp;verdampe;verdampt;verdampte;verdampten;
harmoniseren===harmoniseren;harmoniseer;harmoniseerde;harmoniseerden;harmoniseert;harmonisere;
aarzelen===aarzelen;aarzel;aarzelde;aarzelden;aarzele;aarzelt;
opvolgen===opvolgen;opvolg;opvolgde;opvolgden;opvolge;opvolgt;
pikollen===pikollen;pikolde;pikolden;pikolle;
opzwellen===opzwellen;opzwelle;opzwolle;opzwollen;
bezichtigen===bezichtigen;bezichtig;bezichtigde;bezichtigden;bezichtige;bezichtigt;
verwonderen===verwonderen;verwonder;verwonderde;verwonderden;verwondere;verwondert;
bijknippen===bijknippen;bijknip;bijknippe;bijknipt;bijknipte;bijknipten;
samenvatten===samenvatten;samenvat;samenvatte;
uittikken===uittikken;uittikke;uittikte;uittikten;
atten===atten;atte;
prepareren===prepareren;prepareer;prepareerde;prepareerden;prepareert;preparere;
tutoyeren===tutoyeren;tutoyeer;tutoyeerde;tutoyeerden;tutoyere;
bokken===bokken;bokke;bokten;
verwilderen===verwilderen;verwilder;verwilderde;verwilderden;verwildere;verwildert;
snakken===snakken;snakke;snakte;snakten;
ontbijten===ontbijten;ontbeten;ontbijt;ontbijte;
malverseren===malverseren;malverseer;malverseerde;malverseerden;malverseert;malversere;
bespreken===bespreken;besprake;bespraken;bespreek;bespreke;
vertalen===vertalen;vertaalden;vertale;
pissen===pissen;pisse;pisten;
rantsoeneren===rantsoeneren;rantsoeneer;rantsoeneerde;rantsoeneerden;rantsoeneert;rantsoenere;
slapen===slapen;slape;sliepen;
afbijten===afbijten;afbeten;afbijt;afbijte;
sjoemelen===sjoemelen;sjoemel;sjoemelde;sjoemelden;sjoemele;sjoemelt;
sjouwen===sjouwen;sjouw;sjouwde;sjouwden;sjouwe;sjouwt;
verontreinigen===verontreinigen;verontreinig;verontreinigde;verontreinigden;verontreinige;verontreinigt;
brandschilderen===brandschilderen;brandschilder;brandschilderde;brandschilderden;brandschildere;brandschildert;
decentraliseren===decentraliseren;decentraliseer;decentraliseerde;decentraliseerden;decentraliseert;decentralisere;
gewennen===gewennen;gewende;gewenden;gewenne;
smoren===smoren;smoorden;smore;
schrobben===schrobben;schrobbe;schrobde;schrobden;
doorbrengen===doorbrengen;doorbreng;doorbrenge;doorbrengt;
componeren===componeren;componeer;componeerde;componeerden;componeert;componere;
sorteren===sorteren;sorteer;sorteerden;sortere;
inleiden===inleiden;inleid;inleidde;inleidden;inleide;inleidt;
uitdenken===uitdenken;uitdenk;uitdenke;uitdenkt;
sluiten===sluiten;sloten;sluit;sluite;
hersenspoelen===hersenspoelen;hersenspoel;hersenspoelde;hersenspoelden;hersenspoele;hersenspoelt;
verheiligen===verheiligen;verheilig;verheiligde;verheiligden;verheilige;verheiligt;
optekenen===optekenen;opteken;optekende;optekenden;optekene;optekent;
overzetten===overzetten;overzet;overzette;
opstarten===opstarten;opstart;opstarte;opstartte;opstartten;
versleutelen===versleutelen;versleutel;versleutelde;versleutelden;versleutele;versleutelt;
kwijtschelden===kwijtschelden;kwijtscheld;kwijtschelde;kwijtscheldt;kwijtschold;kwijtscholde;kwijtscholden;kwijtscholdt;
inhuldigen===inhuldigen;inhuldig;inhuldigde;inhuldigden;inhuldige;inhuldigt;
omwentelen===omwentelen;omwentel;omwentelde;omwentelden;omwentele;omwentelt;
achterlaten===achterlaten;achterlaat;achterlate;achterliet;achterliete;achterlieten;
verneuken===verneuken;verneuk;verneuke;verneukt;verneukte;verneukten;
staren===staren;staarden;stare;
diagnostiseren===diagnostiseren;
betreuren===betreuren;betreur;betreurde;betreurden;betreure;betreurt;
namaken===namaken;namaakten;namake;
rijgen===rijgen;rijge;
neerzetten===neerzetten;neerzet;neerzette;
belasteren===belasteren;belaster;belasterde;belasterden;belastere;belastert;
uitklappen===uitklappen;uitklap;uitklappe;uitklapt;uitklapte;uitklapten;
doorgronden===doorgronden;doorgrond;doorgrondde;doorgrondden;doorgronde;doorgrondt;
rijpen===rijpen;rijpe;rijpten;
verplichten===verplichten;verplicht;verplichte;verplichtte;verplichtten;
uitvoeren===uitvoeren;uitvoer;uitvoerde;uitvoerden;uitvoere;uitvoert;
combineren===combineren;combineer;combineerde;combineerden;combineert;combinere;
rondzweven===rondzweven;rondzweef;rondzweefden;rondzweeft;rondzweve;
prutsen===prutsen;pruts;prutse;prutst;prutste;prutsten;
vertegenwoordigen===vertegenwoordigen;vertegenwoordig;vertegenwoordigde;vertegenwoordigden;vertegenwoordige;vertegenwoordigt;
verliezen===verliezen;verlieze;
verwikkelen===verwikkelen;verwikkel;verwikkelde;verwikkelden;verwikkele;verwikkelt;
verweven===verweven;
begaan===begaan;begaat;
beschieten===beschieten;beschiet;beschiete;beschote;beschoten;
spannen===spannen;spande;spanden;spanne;
bazelen===bazelen;bazel;bazelde;bazelden;bazele;bazelt;
aanschuiven===aanschuiven;aanschove;aanschoven;aanschuif;aanschuift;aanschuive;
uiten===uiten;uite;uitten;
vrezen===vrezen;vreze;
bespeuren===bespeuren;bespeur;bespeurde;bespeurden;bespeure;bespeurt;
bevatten===bevatten;bevatte;
exposeren===exposeren;exposeer;exposeerde;exposeerden;exposere;
beoefenen===beoefenen;beoefen;beoefende;beoefenden;beoefene;beoefent;
opheffen===opheffen;opheffe;
tuinieren===tuinieren;tuinier;tuinierde;tuinierden;tuiniere;tuiniert;
huishouden===huishouden;huishielden;huishou;huishoud;huishoude;huishoudt;
beheersen===beheersen;beheers;beheerse;beheerst;beheerste;beheersten;
bezorgen===bezorgen;bezorg;bezorgde;bezorgden;bezorge;bezorgt;
walsen===walsen;walse;walsten;
ontbloten===ontbloten;ontblootte;ontblootten;ontblote;
kabbelen===kabbelen;kabbel;kabbelde;kabbelden;kabbele;kabbelt;
sproeien===sproeien;sproei;sproeide;sproeiden;sproeie;sproeit;
mislukken===mislukken;mislukke;mislukte;mislukten;
houten===houten;houte;houtten;
overdragen===overdragen;overdraag;overdraagt;overdrage;overdroeg;overdroege;overdroegen;
stoelen===stoelen;stoel;stoelde;stoelden;stoele;stoelt;
opfleuren===opfleuren;opfleur;opfleurde;opfleurden;opfleure;opfleurt;
ronselen===ronselen;
dommelen===dommelen;dommel;dommelde;dommelden;dommele;dommelt;
uitsterven===uitsterven;uitsterf;uitsterft;uitsterve;uitstierve;uitstierven;
invangen===invangen;invang;invange;invangt;invinge;invingen;
opstellen===opstellen;opstelde;opstelden;opstelle;
rijzen===rijzen;rijze;
renegeren===renegeren;renegeer;renegeerde;renegeerden;renegere;
kibbelen===kibbelen;kibbel;kibbelde;kibbelden;kibbele;kibbelt;
denderen===denderen;dender;denderde;denderden;dendere;dendert;
aanbrengen===aanbrengen;aanbreng;aanbrenge;aanbrengt;
narekenen===narekenen;nareken;narekende;narekenden;narekene;narekent;
sporten===sporten;sport;sporte;sportte;sportten;
gorgelen===gorgelen;gorgel;gorgelde;gorgelden;gorgele;gorgelt;
opzouten===opzouten;opzout;opzoute;opzoutte;opzoutten;
weren===weren;weerden;were;
verantwoorden===verantwoorden;verantwoord;verantwoordde;verantwoordden;verantwoorde;verantwoordt;
verouderen===verouderen;verouder;verouderde;verouderden;veroudere;veroudert;
opstapelen===opstapelen;opstapel;opstapelde;opstapelden;opstapele;opstapelt;
verheerlijken===verheerlijken;verheerlijk;verheerlijke;verheerlijkt;verheerlijkte;verheerlijkten;
flauwvallen===flauwvallen;flauwval;flauwvalle;flauwvalt;flauwviele;flauwvielen;
gebruiken===gebruiken;gebruik;gebruike;gebruikt;gebruikte;gebruikten;
onderverdelen===onderverdelen;onderverdeel;onderverdeelde;onderverdeelden;onderverdeelt;onderverdele;
vallen===vallen;valle;
verlenen===verlenen;verleen;verleenden;verleent;verlene;
wetten===wetten;wette;
gemoeten===gemoeten;gemoet;gemoete;gemoette;gemoetten;
reppen===reppen;reppe;repten;
stoken===stoken;stoke;stookten;
vervoegen===vervoegen;vervoeg;vervoegde;vervoegden;vervoege;vervoegt;
legen===legen;leegden;lege;
verdrijven===verdrijven;verdreve;verdreven;verdrijf;verdrijft;verdrijve;
beklimmen===beklimmen;beklimme;beklomme;beklommen;
lokken===lokken;lokke;lokten;
uitdoven===uitdoven;uitdoofden;uitdove;
boeren===boeren;boerden;boere;
smeulen===smeulen;smeul;smeulde;smeulden;smeule;smeult;
naasten===naasten;naast;naaste;naastte;naastten;
boffen===boffen;boffe;boften;
snuiten===snuiten;snoten;snuit;snuite;
doneren===doneren;doneer;doneerden;donere;
stagneren===stagneren;stagneer;stagneerde;stagneerden;stagnere;
wonen===wonen;wone;woonden;
jongen===jongen;jongden;jonge;
loslaten===loslaten;loslate;loslieten;
bestrijden===bestrijden;bestrede;bestreden;bestrijd;bestrijde;bestrijdt;
stoten===stoten;stieten;stootten;stote;
aanlachen===aanlachen;aanlach;aanlache;aanlacht;aanlachte;aanlachten;
ontvluchten===ontvluchten;ontvlucht;ontvluchte;ontvluchtte;ontvluchtten;
tegenkomen===tegenkomen;tegenkom;tegenkome;tegenkomt;tegenkwame;tegenkwamen;
bevallen===bevallen;bevalle;bevielen;
braaien===braaien;braai;braaide;braaiden;braaie;braait;
opdienen===opdienen;opdien;opdiende;opdienden;opdiene;opdient;
optrekken===optrekken;optrekke;optrokke;optrokken;
wateren===wateren;water;waterde;waterden;watere;watert;
fluisteren===fluisteren;fluister;fluisterde;fluisterden;fluistere;fluistert;
samenkomen===samenkomen;samenkom;samenkome;samenkomt;samenkwame;samenkwamen;
negeren===negeren;negeer;negeerden;negere;
klotsen===klotsen;
binnenvallen===binnenvallen;binnenval;binnenvalle;binnenvalt;binnenviele;binnenvielen;
ontladen===ontladen;ontlaadden;ontlade;
beramen===beramen;beraamden;berame;
beschuldigen===beschuldigen;beschuldig;beschuldigde;beschuldigden;beschuldige;beschuldigt;
bidden===bidden;bidde;
omrekenen===omrekenen;omreken;omrekende;omrekenden;omrekene;omrekent;
opdoeken===opdoeken;opdoek;opdoeke;opdoekt;opdoekte;opdoekten;
toeteren===toeteren;toeter;toeterde;toeterden;toetere;toetert;
hyperventileren===hyperventileren;hyperventileer;hyperventileerde;hyperventileerden;hyperventileert;hyperventilere;
ploegen===ploegen;ploeg;ploegde;ploegden;ploege;ploegt;
lamenteren===lamenteren;lamenteer;lamenteerde;lamenteerden;lamenteert;lamentere;
omspringen===omspringen;omspring;omspringe;omspringt;omsprong;omspronge;omsprongen;omsprongt;
domesticeren===domesticeren;domesticeer;domesticeerde;domesticeerden;domesticeert;domesticere;
ontdooien===ontdooien;ontdooi;ontdooide;ontdooiden;ontdooie;ontdooit;
equiperen===equiperen;equipeer;equipeerde;equipeerden;equipere;
verzekeren===verzekeren;verzeker;verzekerde;verzekerden;verzekere;verzekert;
meedingen===meedingen;meeding;meedinge;meedingt;meedonge;meedongen;
geeuwen===geeuwen;geeuw;geeuwde;geeuwden;geeuwe;geeuwt;
verwoorden===verwoorden;verwoord;verwoordde;verwoordden;verwoorde;verwoordt;
adverteren===adverteren;adverteer;adverteerde;adverteerden;adverteert;advertere;
skaten===skaten;skate;skatet;skatete;skateten;
brommen===brommen;bromde;bromden;bromme;
stofferen===stofferen;stoffeer;stoffeerde;stoffeerden;stoffere;
versimpelen===versimpelen;versimpel;versimpelde;versimpelden;versimpele;versimpelt;
inkomen===inkomen;inkom;inkome;inkomt;inkwamen;
schuren===schuren;schure;schuurden;
leren===leren;leerden;lere;
afbranden===afbranden;afbrand;afbrandde;afbrandden;afbrande;afbrandt;
opdragen===opdragen;opdrage;opdroegen;
orgelen===orgelen;orgel;orgelde;orgelden;orgele;orgelt;
ophoesten===ophoesten;ophoest;ophoeste;ophoestte;ophoestten;
vinden===vinden;vinde;vonden;
annexeren===annexeren;annexeer;annexeerde;annexeerden;annexere;
vlinderen===vlinderen;vlinder;vlinderde;vlinderden;vlindere;vlindert;
geruststellen===geruststellen;geruststel;geruststelde;geruststelden;geruststelle;geruststelt;
oprollen===oprollen;oprolde;oprolden;oprolle;
nasporen===nasporen;naspoorden;naspore;
teisteren===teisteren;teister;teisterde;teisterden;teistere;teistert;
bedrukken===bedrukken;bedrukke;bedrukte;bedrukten;
tronen===tronen;trone;troonden;
e-mailen===e-mailen;e-mail;e-mailde;e-mailden;e-maile;e-mailt;
verkolen===verkolen;verkole;verkoolden;
selecteren===selecteren;selecteer;selecteerde;selecteerden;selecteert;selectere;
pachten===pachten;pacht;pachte;pachtte;pachtten;
huppen===huppen;
betwisten===betwisten;betwist;betwiste;betwistte;betwistten;
wikkelen===wikkelen;wikkel;wikkelde;wikkelden;wikkele;wikkelt;
uitbetalen===uitbetalen;uitbetaal;uitbetaalde;uitbetaalden;uitbetaalt;uitbetale;
echapperen===echapperen;echappeer;echappeerde;echappeerden;echappeert;echappere;
bestormen===bestormen;bestorm;bestormde;bestormden;bestorme;bestormt;
kriebelen===kriebelen;kriebel;kriebelde;kriebelden;kriebele;kriebelt;
medicineren===medicineren;medicineer;medicineerde;medicineerden;medicineert;medicinere;
baggeren===baggeren;bagger;baggerde;baggerden;baggere;baggert;
beïnvloeden===beïnvloeden;beïnvloed;beïnvloedde;beïnvloedden;beïnvloede;beïnvloedt;
miezeren===miezeren;miezer;miezerde;miezerden;miezere;miezert;
globaliseren===globaliseren;globaliseer;globaliseerde;globaliseerden;globaliseert;globalisere;
worgen===worgen;worgden;worge;
bijdragen===bijdragen;bijdrage;bijdroegen;
ontgaan===ontgaan;ontga;ontgaat;
schaffen===schaffen;schaffe;schafte;schaften;
wekken===wekken;wekke;wekten;
discrimineren===discrimineren;discrimineer;discrimineerde;discrimineerden;discrimineert;discriminere;
huiden===huiden;
smachten===smachten;smacht;smachte;smachtte;smachtten;
uitputten===uitputten;uitputte;
internetten===internetten;internet;internette;
aanspreken===aanspreken;aansprak;aansprake;aanspraken;aanspreek;aanspreekt;aanspreke;
emulgeren===emulgeren;emulgeer;emulgeerde;emulgeerden;emulgere;
navolgen===navolgen;navolg;navolgde;navolgden;navolge;navolgt;
tongzoenen===tongzoenen;tongzoen;tongzoende;tongzoenden;tongzoene;tongzoent;
krukken===krukken;krukke;krukte;krukten;
aanrichten===aanrichten;aanricht;aanrichte;aanrichtte;aanrichtten;
voegen===voegen;voegden;voege;
spietsen===spietsen;spiets;spietse;spietst;spietste;spietsten;
vertrekken===vertrekken;vertrek;vertrekke;vertrekt;vertrokke;vertrokken;
zinnen===zinnen;zinden;zinne;
voorzien===voorzien;voorzagen;voorzie;voorziet;
crashen===crashen;crash;crashe;crasht;crashte;crashten;
ridderen===ridderen;ridder;ridderde;ridderden;riddere;riddert;
snorren===snorren;snorde;snorden;snorre;
afwijzen===afwijzen;afwezen;afwijze;
huwen===huwen;huwden;huwe;
hurken===hurken;hurke;hurkten;
fantaseren===fantaseren;fantaseer;fantaseerde;fantaseerden;fantaseert;fantasere;
abstraheren===abstraheren;abstraheer;abstraheerde;abstraheerden;abstraheert;abstrahere;
vindiceren===vindiceren;vindiceer;vindiceerde;vindiceerden;vindiceert;vindicere;
stromen===stromen;strome;stroomden;
vermorsen===vermorsen;vermors;vermorse;vermorst;vermorste;vermorsten;
tranen===tranen;traanden;trane;
betrappen===betrappen;betrappe;betrapte;betrapten;
uitbarsten===uitbarsten;uitbarst;uitbarste;uitbarstte;uitbarstten;
bombarderen===bombarderen;bombardeer;bombardeerde;bombardeerden;bombardeert;bomberdere;bomberderen;
onderwerpen===onderwerpen;onderwerp;onderwerpe;onderwerpt;onderwierp;onderwierpe;onderwierpen;onderwierpt;
fierljeppen===fierljeppen;fierljep;fierljeppe;fierljept;fierljepte;fierljepten;
uiteenvallen===uiteenvallen;uiteenval;uiteenvalle;uiteenvalt;uiteenviele;uiteenvielen;
overtuigen===overtuigen;overtuig;overtuigde;overtuigden;overtuige;overtuigt;
oppikken===oppikken;oppikke;oppikte;oppikten;
uitscheiden===uitscheiden;uitschede;uitscheden;uitscheed;uitscheedt;uitscheid;uitscheidde;uitscheidden;uitscheide;uitscheidt;
vellen===vellen;velden;velle;
verschijnen===verschijnen;verscheen;verschene;verschenen;verschijn;verschijne;verschijnt;
dingen===dingen;dinge;dongen;
versoepelen===versoepelen;versoepel;versoepelde;versoepelden;versoepele;versoepelt;
inzoomen===inzoomen;inzoom;inzoomde;inzoomden;inzoome;inzoomt;
vervagen===vervagen;vervaagden;vervage;
smeken===smeken;smeekten;smeke;
krassen===krassen;krasse;kraste;krasten;
zouten===zouten;zoute;zoutten;
barbecueën===barbecueën;barbecue;barbecuede;barbecueden;barbecuet;barbecueë;
buitmaken===buitmaken;buitmaakte;buitmaakten;buitmake;
slinken===slinken;slink;slinke;slinkt;slonke;slonken;
opruimen===opruimen;opruim;opruimde;opruimden;opruime;opruimt;
uitdunnen===uitdunnen;uitdunde;uitdunden;uitdunne;
inzetten===inzetten;inzette;
erkennen===erkennen;erkende;erkenden;erkenne;
schijten===schijten;scheten;schijt;schijte;
vergaren===vergaren;vergaarden;vergare;
bedoelen===bedoelen;bedoel;bedoelde;bedoelden;bedoele;bedoelt;
beogen===beogen;beoge;beoogden;
verzwaren===verzwaren;verzwaarde;verzwaarden;verzware;
herformuleren===herformuleren;herformuleer;herformuleerde;herformuleerden;herformuleert;herformulere;
corresponderen===corresponderen;correspondeer;correspondeerde;correspondeerden;correspondeert;correspondere;
haasten===haasten;haast;haaste;haastte;haastten;
kijken===kijken;kijke;
besabbelen===besabbelen;besabbel;besabbelde;besabbelden;besabbele;besabbelt;
cederen===cederen;cedeer;cedeerden;cedere;
jagen===jagen;jaagden;jage;
voortdrijven===voortdrijven;voortdreve;voortdreven;voortdrijf;voortdrijft;voortdrijve;
produceren===produceren;produceer;produceerde;produceerden;produceert;producere;
schaften===schaften;schaft;schafte;schaftte;schaftten;
zwinden===zwinden;zwind;zwinde;zwindt;zwonde;zwonden;
herhalen===herhalen;herhaalden;herhale;
dollen===dollen;dolden;dolle;
factureren===factureren;factureer;factureerde;factureerden;factureert;facturere;
bewapenen===bewapenen;bewapen;bewapende;bewapenden;bewapene;bewapent;
klauteren===klauteren;klauter;klauterde;klauterden;klautere;klautert;
bezoeken===bezoeken;bezoek;bezoeke;bezoekt;
typen===typen;type;typten;
motorboten===motorboten;motorboot;motorbootte;motorbootten;motorbote;
leveren===leveren;lever;leverde;leverden;levere;levert;
bestraffen===bestraffen;bestraf;bestraffe;bestraft;bestrafte;bestraften;
krommen===krommen;kromde;kromden;kromme;
behoren===behoren;behoorden;behore;
bedruipen===bedruipen;bedropen;bedruip;bedruipe;bedruipt;
verzuren===verzuren;verzure;verzuurden;
ontbieden===ontbieden;ontbied;ontbiede;ontbiedt;ontboden;
tegenwerken===tegenwerken;tegenwerk;tegenwerke;tegenwerkt;tegenwerkte;tegenwerkten;
verduisteren===verduisteren;verduister;verduisterde;verduisterden;verduistere;verduistert;
overspannen===overspannen;overspan;overspande;overspanden;overspanne;overspant;
vermaren===vermaren;vermaarden;vermare;
inzien===inzien;inzagen;inzie;inziet;
behangen===behangen;behang;behange;behangt;behinge;behingen;
duizelen===duizelen;duizel;duizelde;duizelden;duizele;duizelt;
vermaken===vermaken;vermaakten;vermake;
stikken===stikken;stikke;stikte;stikten;
verdringen===verdringen;verdring;verdringe;verdringt;verdrong;verdronge;verdrongen;verdrongt;
bemoedigen===bemoedigen;bemoedig;bemoedigde;bemoedigden;bemoedige;bemoedigt;
tanken===tanken;tanke;tankten;
muteren===muteren;muteer;muteerden;mutere;
omsluiten===omsluiten;omsloten;omsluit;omsluite;
schouwen===schouwen;schouw;schouwde;schouwden;schouwe;schouwt;
inblikken===inblikken;inblikke;inblikte;inblikten;
tikken===tikken;tikke;tikten;
roeren===roeren;roerden;roere;
vernoemen===vernoemen;vernoem;vernoemde;vernoemden;vernoeme;vernoemt;
jubelen===jubelen;jubel;jubelde;jubelden;jubele;jubelt;
ruien===ruien;ruiden;ruie;
vermengen===vermengen;vermeng;vermengde;vermengden;vermenge;vermengt;
instellen===instellen;instelde;instelden;instelle;
ijsberen===ijsberen;ijsbeer;ijsbeerden;ijsbere;
aantasten===aantasten;aantast;aantaste;aantastte;aantastten;
representeren===representeren;representeer;representeerde;representeerden;representeert;representere;
omroepen===omroepen;omriepe;omriepen;omroep;omroepe;omroept;
uitmaken===uitmaken;uitmaakten;uitmake;
spijbelen===spijbelen;spijbel;spijbelde;spijbelden;spijbele;spijbelt;
schoonwassen===schoonwassen;schoonwas;schoonwasse;schoonwast;schoonwaste;schoonwasten;
verdiepen===verdiepen;verdiep;verdiepe;verdiept;verdiepte;verdiepten;
banen===banen;baanden;bane;
afvallen===afvallen;afvalle;afvielen;
voorzijn===voorzijn;voorzij;voorzijt;
mompelen===mompelen;mompel;mompelde;mompelden;mompele;mompelt;
bekakken===bekakken;bekakke;bekakte;bekakten;
emotioneren===emotioneren;emotioneer;emotioneerde;emotioneerden;emotioneert;emotionere;
lospeuteren===lospeuteren;
druppelen===druppelen;druppel;druppelde;druppelden;druppele;druppelt;
teleurstellen===teleurstellen;teleurstel;teleurstelde;teleurstelden;teleurstelle;teleurstelt;
verachten===verachten;veracht;verachte;verachtte;verachtten;
kneden===kneden;knede;kneedden;
brullen===brullen;brulde;brulden;brulle;
posten===posten;poste;postten;
toestemmen===toestemmen;toestem;toestemde;toestemden;toestemme;toestemt;
vasthouden===vasthouden;vasthielden;vasthou;vasthoud;vasthoude;vasthoudt;
garanderen===garanderen;garandeer;garandeerde;garandeerden;garandeert;garandere;
dwarszitten===dwarszitten;dwarszate;dwarszaten;dwarszit;dwarszitte;
aangroeien===aangroeien;aangroei;aangroeide;aangroeiden;aangroeie;aangroeit;
overleggen===overleggen;overleg;overlegde;overlegden;overlegge;overlegt;
treuren===treuren;treur;treurde;treurden;treure;treurt;
kalven===kalven;kalfden;kalve;
dopen===dopen;doopten;dope;
aanliggen===aanliggen;aanlagen;aanligge;
vruchten===vruchten;vrucht;vruchte;vruchtte;vruchtten;
golven===golven;golfden;golve;
consumeren===consumeren;consumeer;consumeerde;consumeerden;consumeert;consumere;
drammen===drammen;dramde;dramden;dramme;
kluisteren===kluisteren;kluister;kluisterde;kluisterden;kluistere;kluistert;
ontgroeien===ontgroeien;ontgroei;ontgroeide;ontgroeiden;ontgroeie;ontgroeit;
evolueren===evolueren;evolueer;evolueerde;evolueerden;evoluere;
overkoepelen===overkoepelen;overkoepel;overkoepelde;overkoepelden;overkoepele;overkoepelt;
wachten===wachten;wacht;wachte;wachtte;wachtten;
uitbotten===uitbotten;uitbotte;
afleggen===afleggen;aflegde;aflegden;aflegge;
neergooien===neergooien;neergooi;neergooide;neergooiden;neergooie;neergooit;
wennen===wennen;wenden;wenne;
beffen===beffen;beffe;beften;
synthetiseren===synthetiseren;synthetiseer;synthetiseerde;synthetiseerden;synthetiseert;synthetisere;
zwetsen===zwetsen;zwets;zwetse;zwetst;zwetste;zwetsten;
welven===welven;welfden;welve;
choqueren===choqueren;choqueer;choqueerde;choqueerden;choquere;
staan===staan;staat;
vastknopen===vastknopen;vastknoop;vastknoopt;vastknoopte;vastknoopten;vastknope;
stelen===stelen;stalen;stele;
neerstorten===neerstorten;neerstort;neerstorte;neerstortte;neerstortten;
lukken===lukken;lukke;lukten;
opleiden===opleiden;opleid;opleidde;opleidden;opleide;opleidt;
ombrengen===ombrengen;ombreng;ombrenge;ombrengt;
verdubbelen===verdubbelen;verdubbel;verdubbelde;verdubbelden;verdubbele;verdubbelt;
boetseren===boetseren;boetseer;boetseerde;boetseerden;boetsere;
mankeren===mankeren;mankeer;mankeerden;mankere;
ijveren===ijveren;ijver;ijverde;ijverden;ijvere;ijvert;
mobiliseren===mobiliseren;mobiliseer;mobiliseerde;mobiliseerden;mobiliseert;mobilisere;
gieten===gieten;giete;
uitladen===uitladen;uitlaadden;uitlade;
uitnemen===uitnemen;uitname;uitnamen;uitneem;uitneme;
jetskiën===jetskiën;jetski;jetskieden;jetskiet;jetskië;
oplossen===oplossen;oplosse;oploste;oplosten;
kiemen===kiemen;kiemden;kieme;
capituleren===capituleren;capituleer;capituleerde;capituleerden;capituleert;capitulere;
raspen===raspen;raspe;raspten;
wellen===wellen;welden;welle;
schrikken===schrikken;schrikke;schrokke;schrokken;
vergunnen===vergunnen;vergunde;vergunden;vergunne;
uitdrukken===uitdrukken;uitdruk;uitdrukke;uitdrukt;uitdrukte;uitdrukten;
activeren===activeren;activeer;activeerde;activeerden;activere;
exporteren===exporteren;exporteer;exporteerde;exporteerden;exporteert;exportere;
bewerken===bewerken;bewerk;bewerke;bewerkt;bewerkte;bewerkten;
opschieten===opschieten;opschiet;opschiete;opschote;opschoten;
opensperren===opensperren;opensper;opensperde;opensperden;opensperre;openspert;
indelen===indelen;indeel;indeelden;indele;
doorboren===doorboren;doorboorde;doorboorden;doorbore;
aankopen===aankopen;aankochten;aankope;
terugvallen===terugvallen;terugval;terugvalle;terugvalt;terugviele;terugvielen;
arresteren===arresteren;arresteer;arresteerde;arresteerden;arresteert;arrestere;
raadplegen===raadplegen;raadpleeg;raadpleegde;raadpleegden;raadpleegt;raadplege;
huisvesten===huisvesten;huisvest;huisveste;huisvestte;huisvestten;
insluiten===insluiten;insloten;insluit;insluite;
balken===balken;balke;balkten;
studeren===studeren;studeer;studeerden;studere;
obsederen===obsederen;obsedeer;obsedeerde;obsedeerden;obsedere;
onderstrepen===onderstrepen;onderstreep;onderstreept;onderstreepte;onderstreepten;onderstrepe;
smeden===smeden;smede;smeedden;
ontspringen===ontspringen;ontspring;ontspringe;ontspringt;ontsprong;ontspronge;ontsprongen;ontsprongt;
teruggaan===teruggaan;terugga;teruggaat;
ontsporen===ontsporen;ontspoorde;ontspoorden;ontspore;
kwellen===kwellen;kwelde;kwelden;kwelle;
beroven===beroven;berove;
corroderen===corroderen;
verschroeien===verschroeien;verschroei;verschroeide;verschroeiden;verschroeie;verschroeit;
verafgoden===verafgoden;verafgode;verafgood;verafgoodde;verafgoodden;verafgoodt;
verzengen===verzengen;verzeng;verzengde;verzengden;verzenge;verzengt;
hossen===hossen;hosse;hosten;
hervormen===hervormen;hervorm;hervormde;hervormden;hervorme;hervormt;
kwijtraken===kwijtraken;kwijtraak;kwijtraakt;kwijtraakte;kwijtraakten;kwijtrake;
verspillen===verspillen;verspil;verspilde;verspilden;verspille;verspilt;
snuffelen===snuffelen;snuffel;snuffelde;snuffelden;snuffele;snuffelt;
afzeggen===afzeggen;afzegde;afzegden;afzegge;afzeiden;
slippen===slippen;slippe;slipte;slipten;
uitkomen===uitkomen;uitkom;uitkome;uitkomt;uitkwamen;
opzoeken===opzoeken;opzoek;opzoeke;opzoekt;
omfloersen===omfloersen;omfloers;omfloerse;omfloerst;omfloerste;omfloersten;
teweegbrengen===teweegbrengen;teweegbrachten;teweegbreng;teweegbrenge;teweegbrengt;
proflecteren===proflecteren;proflecteer;proflecteerde;proflecteerden;proflecteert;proflectere;
rondlopen===rondlopen;rondliepen;rondlope;
formaliseren===formaliseren;formaliseer;formaliseerde;formaliseerden;formaliseert;formalisere;
roken===roken;roke;rookten;
verassen===verassen;verasse;veraste;verasten;
stralen===stralen;straalden;strale;
omdraaien===omdraaien;omdraai;omdraaide;omdraaiden;omdraaie;omdraait;
beslechten===beslechten;beslecht;beslechte;beslechtte;beslechtten;
confisqueren===confisqueren;confisqueer;confisqueerde;confisqueerden;confisqueert;confisquere;
uitgroeien===uitgroeien;uitgroei;uitgroeide;uitgroeiden;uitgroeie;uitgroeit;
opmaken===opmaken;opmaakten;opmake;
dobbelen===dobbelen;dobbel;dobbelde;dobbelden;dobbele;dobbelt;
witten===witten;witte;
gillen===gillen;gilden;gille;
hernemen===hernemen;hername;hernamen;herneem;herneme;
chanten===chanten;chant;chante;chantte;chantten;
berichten===berichten;bericht;berichte;berichtte;berichtten;
zitten===zitten;zitte;
aannemen===aannemen;aanname;aannamen;aanneem;aanneme;
overdenken===overdenken;overdenk;overdenke;overdenkt;
hernoemen===hernoemen;hernoem;hernoemde;hernoemden;hernoeme;hernoemt;
schuiven===schuiven;schoven;schuive;
opschrijven===opschrijven;opschreve;opschreven;opschrijf;opschrijft;opschrijve;
overstelpen===overstelpen;overstelp;overstelpe;overstelpt;overstelpte;overstelpten;
checken===checken;check;checke;checkt;checkte;checkten;
wurmen===wurmen;wurmden;wurme;
verfomfaaien===verfomfaaien;verfomfaai;verfomfaaide;verfomfaaiden;verfomfaaie;verfomfaait;
parkeren===parkeren;parkeer;parkeerden;parkere;
decimeren===decimeren;decimeer;decimeerde;decimeerden;decimere;
dempen===dempen;dempe;dempten;
wegsturen===wegsturen;wegsture;wegstuurde;wegstuurden;
ademen===ademen;ademden;ademe;
volbrengen===volbrengen;volbreng;volbrenge;volbrengt;
afvoeren===afvoeren;afvoer;afvoerde;afvoerden;afvoere;afvoert;
uitlachen===uitlachen;uitlach;uitlache;uitlacht;uitlachte;uitlachten;
fluiten===fluiten;floten;fluit;fluite;
innen===innen;inden;inne;
katten===katten;katte;
meenemen===meenemen;meename;meenamen;meeneem;meeneme;
minachten===minachten;minacht;minachte;minachtte;minachtten;
opvangen===opvangen;opvang;opvange;opvangt;opvinge;opvingen;
blaffen===blaffen;blaffe;blafte;blaften;
uitkijken===uitkijken;uitkeken;uitkijk;uitkijke;uitkijkt;
bestaan===bestaan;besta;bestaat;
converteren===converteren;converteer;converteerde;converteerden;converteert;convertere;
wegen===wegen;wege;wogen;
beraden===beraden;beraadden;berade;berieden;
morsen===morsen;morse;morsten;
loten===loten;lootten;lote;
meewerken===meewerken;meewerk;meewerke;meewerkt;meewerkte;meewerkten;
engageren===engageren;engageer;engageerde;engageerden;engagere;
inpakken===inpakken;inpakke;inpakte;inpakten;
meubileren===meubileren;meubileer;meubileerde;meubileerden;meubileert;meubilere;
aarden===aarden;aardden;aarde;
rotten===rotten;
besluiten===besluiten;besloten;besluit;besluite;
bezetten===bezetten;bezette;
pellen===pellen;pelden;pelle;
terugtrekken===terugtrekken;terugtrek;terugtrekke;terugtrekt;terugtrokke;terugtrokken;
knellen===knellen;knelde;knelden;knelle;
achterblijven===achterblijven;achterbleve;achterbleven;achterblijf;achterblijft;achterblijve;
daveren===daveren;daver;daverde;daverden;davere;davert;
deugen===deugen;deugden;deuge;
vergezellen===vergezellen;vergezel;vergezelde;vergezelden;vergezelle;vergezelt;
lijken===lijken;lijke;
terugvinden===terugvinden;terugvind;terugvinde;terugvindt;terugvond;terugvonde;terugvonden;terugvondt;
invriezen===invriezen;invrieze;
zagen===zagen;zaagden;zage;
dwalen===dwalen;dwaalden;dwale;
verschansen===verschansen;verschans;verschanse;verschanst;verschanste;verschansten;
verrekken===verrekken;verrekke;verrekte;verrekten;
kreuken===kreuken;kreuk;kreuke;kreukt;kreukte;kreukten;
uitdelen===uitdelen;uitdeel;uitdeelden;uitdele;
toevertrouwen===toevertrouwen;toevertrouw;toevertrouwde;toevertrouwden;toevertrouwe;toevertrouwt;
vervullen===vervullen;vervulde;vervulden;vervulle;
laarzen===laarzen;laarsden;laarze;
overgieten===overgieten;
doseren===doseren;doseer;doseerden;dosere;
vergaan===vergaan;verga;vergaat;
veroveren===veroveren;verover;veroverde;veroverden;verovere;verovert;
menen===menen;meen;meenden;mene;
schuinen===schuinen;schuin;schuinde;schuinden;schuine;schuint;
dorsen===dorsen;dorse;dorsten;
programmeren===programmeren;programmeer;programmeerde;programmeerden;programmeert;programmere;
duikelen===duikelen;duikel;duikelde;duikelden;duikele;duikelt;
bebouwen===bebouwen;bebouw;bebouwde;bebouwden;bebouwe;bebouwt;
omgeven===omgeven;omgave;omgaven;omgeef;omgeve;
pintelieren===pintelieren;pintelier;pintelierde;pintelierden;pinteliere;pinteliert;
veronderstellen===veronderstellen;veronderstel;veronderstelde;veronderstelden;veronderstelle;veronderstelt;
bemachtigen===bemachtigen;bemachtig;bemachtigde;bemachtigden;bemachtige;bemachtigt;
begeven===begeven;begave;begaven;begeef;begeve;
belasten===belasten;belast;belaste;belastte;belastten;
watertanden===watertanden;watertand;watertandde;watertandden;watertande;watertandt;
gissen===gissen;gisse;gisten;
omkeren===omkeren;omkeer;omkeerden;omkere;
sleeën===sleeën;sleeden;sleeë;
korten===korten;korte;kortten;
hoeden===hoeden;hoedden;hoede;
martelen===martelen;martel;martelde;martelden;martele;martelt;
smoezen===smoezen;smoesden;smoeze;
velen===velen;veelden;vele;
aanhebben===aanhebben;aanhebbe;
overrijden===overrijden;overrede;overreden;overrijd;overrijde;overrijdt;
aanranden===aanranden;aanrand;aanrandde;aanrandden;aanrande;aanrandt;
ontduiken===ontduiken;ontdoken;ontduik;ontduike;ontduikt;
aanschaffen===aanschaffen;aanschaf;aanschaffe;aanschaft;aanschafte;aanschaften;
aanleren===aanleren;aanleer;aanleerden;aanlere;
samenvallen===samenvallen;
opklaren===opklaren;opklaarden;opklare;
durven===durven;durfden;durve;
kisten===kisten;kiste;kistten;
vaststellen===vaststellen;vaststel;vaststelde;vaststelden;vaststelle;vaststelt;
hijsen===hijsen;hijse;
doorzien===doorzien;doorzagen;doorzie;doorziet;
rommelen===rommelen;rommel;rommelde;rommelden;rommele;rommelt;
ontkiemen===ontkiemen;ontkiem;ontkiemde;ontkiemden;ontkieme;ontkiemt;
tillen===tillen;tilden;tille;
verhaspelen===verhaspelen;verhaspel;verhaspelde;verhaspelden;verhaspele;verhaspelt;
vernieuwen===vernieuwen;vernieuw;vernieuwde;vernieuwden;vernieuwe;vernieuwt;
neuspeuteren===neuspeuteren;
pollen===pollen;pollden;polle;
kuisen===kuisen;kuise;kuisten;
terugspoelen===terugspoelen;terugspoel;terugspoelde;terugspoelden;terugspoele;terugspoelt;
schroeien===schroeien;schroei;schroeide;schroeiden;schroeie;schroeit;
opgraven===opgraven;opgrave;opgroeven;
bundelen===bundelen;bundel;bundelde;bundelden;bundele;bundelt;
schaatsen===schaatsen;schaats;schaatse;schaatst;schaatste;schaatsten;
aanzitten===aanzitten;aanzaten;aanzitte;
amenen===amenen;amenden;amene;
kussen===kussen;kusse;kusten;
uitzweten===uitzweten;uitzweet;uitzweette;uitzweetten;uitzwete;
inluiden===inluiden;inluid;inluidde;inluidden;inluide;inluidt;
vervroegen===vervroegen;vervroeg;vervroegde;vervroegden;vervroege;vervroegt;
blaken===blaken;blaakten;blake;
aanraken===aanraken;aanraakten;aanrake;
afwijken===afwijken;afweken;afwijk;afwijke;afwijkt;
afrijten===afrijten;
samenroepen===samenroepen;samenriep;samenriepe;samenriepen;samenriept;samenroep;samenroepe;samenroept;
bijvallen===bijvallen;bijvalle;bijvielen;
overschrijden===overschrijden;overschrede;overschreden;overschrijd;overschrijde;overschrijdt;
googlen===googlen;
voetballen===voetballen;voetbal;voetbalde;voetbalden;voetballe;voetbalt;
dartelen===dartelen;dartel;dartelde;dartelden;dartele;dartelt;
barbecuen===barbecuen;barbecue;barbecuede;barbecueden;barbecuet;
letten===letten;lette;
ontbranden===ontbranden;ontbrand;ontbrandde;ontbrandden;ontbrande;ontbrandt;
koloniseren===koloniseren;koloniseer;koloniseerde;koloniseerden;koloniseert;kolonisere;
ingeven===ingeven;ingave;ingaven;ingeef;ingeve;
sjorren===sjorren;sjorde;sjorden;sjorre;
zoeten===zoeten;zoete;zoetten;
overeenstemmen===overeenstemmen;overeenstem;overeenstemde;overeenstemden;overeenstemme;overeenstemt;
verpotten===verpotten;verpotte;
kraken===kraken;kraakten;krake;
pogen===pogen;poge;poogden;
weggooien===weggooien;weggooi;weggooide;weggooiden;weggooie;weggooit;
bekken===bekken;bekke;bekten;
optreden===optreden;optrade;optraden;optrede;optreed;
neigen===neigen;neigden;neige;
afschudden===afschudden;
vuisten===vuisten;vuist;vuiste;vuistte;vuistten;
inhouden===inhouden;inhoud;inhoude;inhoudt;
machtigen===machtigen;machtig;machtigde;machtigden;machtige;machtigt;
beklagen===beklagen;beklaagden;beklage;
skiën===skiën;skië;
schoffelen===schoffelen;schoffel;schoffelde;schoffelden;schoffele;schoffelt;
uitvechten===uitvechten;uitvecht;uitvechte;uitvocht;uitvochte;uitvochten;
spreken===spreken;sprake;spraken;spreek;spreke;
opgroeien===opgroeien;
verplegen===verplegen;verpleeg;verpleegde;verpleegden;verplege;
blozen===blozen;bloze;
onderhandelen===onderhandelen;onderhandel;onderhandelde;onderhandelden;onderhandele;onderhandelt;
organiseren===organiseren;organiseer;organiseerde;organiseerden;organiseert;organisere;
presenteren===presenteren;presenteer;presenteerde;presenteerden;presenteert;presentere;
verbrijzelen===verbrijzelen;verbrijzel;verbrijzelde;verbrijzelden;verbrijzele;verbrijzelt;
verpanden===verpanden;verpand;verpandde;verpandden;verpande;verpandt;
behoeven===behoeven;behoefden;behoeve;
bekeren===bekeren;bekeer;bekeerden;beker;bekerde;bekerden;bekere;bekert;
poetsen===poetsen;poets;poetse;poetst;poetste;poetsten;
centraliseren===centraliseren;centraliseer;centraliseerde;centraliseerden;centraliseert;centralisere;
groeperen===groeperen;groepeer;groepeerde;groepeerden;groepere;
overschrijven===overschrijven;overschreve;overschreven;overschrijf;overschrijft;overschrijve;
doppen===doppen;doppe;dopten;
klimmen===klimmen;klimme;klomme;klommen;
lezen===lezen;lazen;leze;
joelen===joelen;joelden;joele;
bikken===bikken;bikke;bikten;
condoleren===condoleren;condoleer;condoleerde;condoleerden;condoleert;condolere;
wissen===wissen;wisse;wisten;
blaten===blaten;blaatten;blate;
uitdrogen===uitdrogen;uitdroge;uitdroogde;uitdroogden;
zweten===zweten;zweetten;zwete;
beëindigen===beëindigen;beëindig;beëindigde;beëindigden;beëindige;beëindigt;
meebetalen===meebetalen;meebetaal;meebetaalde;meebetaalden;meebetaalt;meebetale;
uitwringen===uitwringen;uitwring;uitwringe;uitwringt;uitwrong;uitwronge;uitwrongen;uitwrongt;
inlichten===inlichten;inlicht;inlichte;inlichtte;inlichtten;
openen===openen;openden;opene;
digereren===digereren;digereer;digereerde;digereerden;digerere;
schommelen===schommelen;schommel;schommelde;schommelden;schommele;schommelt;
bewaken===bewaken;bewaakten;bewake;
vergooien===vergooien;vergooi;vergooide;vergooiden;vergooie;vergooit;
indienen===indienen;indien;indiende;indienden;indiene;indient;
aftrekken===aftrekken;aftrekke;aftrokke;aftrokken;
huichelen===huichelen;huichel;huichelde;huichelden;huichele;huichelt;
verlossen===verlossen;verlosse;verloste;verlosten;
aanbouwen===aanbouwen;
schromen===schromen;schrome;schroomden;
afmaken===afmaken;afmaakten;afmake;
verlaten===verlaten;verlaatten;verlate;verlieten;
meuken===meuken;meuke;meukten;
binnengaan===binnengaan;binnenga;binnengaat;binnenging;
aanraden===aanraden;aanraadden;aanrade;aanrieden;
overvliegen===overvliegen;overvlieg;overvliege;overvliegt;overvloge;overvlogen;
uitzoomen===uitzoomen;uitzoom;uitzoomde;uitzoomden;uitzoome;uitzoomt;
invullen===invullen;invulde;invulden;invulle;
voortzetten===voortzetten;voortzet;voortzette;
classificeren===classificeren;classificeer;classificeerde;classificeerden;classificeert;classificere;
smaken===smaken;smaakten;smake;
aanroepen===aanroepen;aanriepe;aanriepen;aanroep;aanroepe;aanroept;
veroordelen===veroordelen;veroordeel;veroordeelde;veroordeelden;veroordeelt;veroordele;
opladen===opladen;oplaadden;oplade;
juichen===juichen;juich;juiche;juicht;juichte;juichten;
vervoeren===vervoeren;vervoer;vervoerde;vervoerden;vervoere;vervoert;
prikken===prikken;prikke;prikte;prikten;
dolken===dolken;dolke;dolkten;
navigeren===navigeren;navigeer;navigeerde;navigeerden;navigere;
voorsorteren===voorsorteren;voorsorteer;voorsorteerde;voorsorteerden;voorsorteert;voorsortere;
oppakken===oppakken;oppakke;oppakte;oppakten;
terugplooien===terugplooien;
differentiëren===differentiëren;differentieer;differentieerde;differentieerden;differentieert;differentiëre;
meekomen===meekomen;meekom;meekome;meekomt;meekwamen;
oprotten===oprotten;oprotte;
zalven===zalven;zalfden;zalve;
haperen===haperen;haper;haperde;haperden;hapere;hapert;
overbrengen===overbrengen;overbreng;overbrenge;overbrengt;
verdichten===verdichten;verdicht;verdichte;verdichtte;verdichtten;
betekenen===betekenen;beteken;betekende;betekenden;betekene;betekent;
ontdeken===ontdeken;
aansteken===aansteken;aanstake;aanstaken;aansteek;aansteke;
vergrijzen===vergrijzen;vergrijs;vergrijsde;vergrijsden;vergrijst;vergrijze;
verwaarlozen===verwaarlozen;verwaarloos;verwaarloosden;verwaarloost;verwaarloze;
ophangen===ophangen;ophang;ophange;ophangt;ophinge;ophingen;
bussen===bussen;busse;busten;
camoufleren===camoufleren;camoufleer;camoufleerde;camoufleerden;camoufleert;camouflere;
adviseren===adviseren;adviseer;adviseerde;adviseerden;advisere;
kantelen===kantelen;kantel;kantelde;kantelden;kantele;kantelt;
turven===turven;turfden;turve;
aankijken===aankijken;aankeken;aankijk;aankijke;aankijkt;
vermageren===vermageren;vermager;vermagerde;vermagerden;vermagere;vermagert;
bedreigen===bedreigen;bedreig;bedreigde;bedreigden;bedreige;bedreigt;
instuderen===instuderen;instudeer;instudeerde;instudeerden;instudeert;instudere;
indexeren===indexeren;indexeer;indexeerde;indexeerden;indexere;
oprichten===oprichten;opricht;oprichte;oprichtte;oprichtten;
serveren===serveren;serveer;serveerden;servere;
verladen===verladen;verlaadden;verlade;
prijzen===prijzen;prezen;prijsden;prijze;
waaien===waaien;waaiden;waaie;
aanleggen===aanleggen;aanlegde;aanlegden;aanlegge;
boycotten===boycotten;boycotte;
aftellen===aftellen;aftelde;aftelden;aftelle;
verwerpen===verwerpen;verwerp;verwerpe;verwerpt;verwierpe;verwierpen;
slikken===slikken;slikke;slikte;slikten;
insteken===insteken;instake;instaken;insteek;insteke;
verkreukelen===verkreukelen;verkreukel;verkreukelde;verkreukelden;verkreukele;verkreukelt;
afstemmen===afstemmen;afstemde;afstemden;afstemme;
versperren===versperren;versper;versperde;versperden;versperre;verspert;
opsnuiven===opsnuiven;opsnoven;opsnuive;
vermenigvuldigen===vermenigvuldigen;vermenigvuldig;vermenigvuldigde;vermenigvuldigden;vermenigvuldige;vermenigvuldigt;
besturen===besturen;besture;bestuurden;
afdekken===afdekken;afdekke;afdekte;afdekten;
inroepen===inroepen;inriepe;inriepen;inroep;inroepe;inroept;
neerbuigen===neerbuigen;neerboge;neerbogen;neerbuig;neerbuige;neerbuigt;
kleden===kleden;klede;kleedden;
naleven===naleven;naleef;naleve;
uitrusten===uitrusten;uitrust;uitruste;uitrustte;uitrustten;
hanteren===hanteren;hanteer;hanteerden;hantere;
revolteren===revolteren;revolteer;revolteerde;revolteerden;revolteert;revoltere;
snoepen===snoepen;snoep;snoepe;snoept;snoepte;snoepten;
beschrijven===beschrijven;beschreve;beschreven;beschrijf;beschrijft;beschrijve;
vermogen===vermogen;vermochten;vermoge;
afschrikken===afschrikken;afschrik;afschrikke;afschrikt;afschrikte;afschrikten;
verchromen===verchromen;verchrome;verchroom;verchroomde;verchroomden;verchroomt;
droeven===droeven;droefden;droeve;
brunchen===brunchen;brunch;brunche;bruncht;brunchte;brunchten;
schillen===schillen;schilde;schilden;schille;
besmetten===besmetten;besmette;
uitbrengen===uitbrengen;uitbreng;uitbrenge;uitbrengt;
plannen===plannen;plande;planden;planne;
domineren===domineren;domineer;domineerde;domineerden;dominere;
venten===venten;vente;ventten;
afkijken===afkijken;afkeken;afkijk;afkijke;afkijkt;
ontmaskeren===ontmaskeren;ontmasker;ontmaskerde;ontmaskerden;ontmaskere;ontmaskert;
malen===malen;maalden;male;
kuchen===kuchen;kuche;kuchten;
rusten===rusten;ruste;rustten;
afgelasten===afgelasten;afgelast;afgelaste;afgelastte;afgelastten;
persisteren===persisteren;persisteer;persisteerde;persisteerden;persisteert;persistere;
bevriezen===bevriezen;bevrieze;
spugen===spugen;spuge;spuugden;
onderkennen===onderkennen;onderken;onderkende;onderkenden;onderkenne;onderkent;
sneuvelen===sneuvelen;sneuvel;sneuvelde;sneuvelden;sneuvele;sneuvelt;
dichten===dichten;dicht;dichte;dichtte;dichtten;
uitdoen===uitdoen;uitdeden;uitdeed;uitdoe;uitdoet;
stofzuigen===stofzuigen;stofzuig;stofzuigde;stofzuigden;stofzuige;stofzuigt;
naderen===naderen;nader;naderde;naderden;nadere;nadert;
afbrokkelen===afbrokkelen;afbrokkel;afbrokkelde;afbrokkelden;afbrokkele;afbrokkelt;
bedotten===bedotten;bedotte;
floppen===floppen;floppe;flopte;flopten;
terugwinnen===terugwinnen;terugwin;terugwinne;terugwint;terugwonne;terugwonnen;
waden===waden;waadden;wade;
omrijden===omrijden;omreden;omrijd;omrijde;omrijdt;
uitzenden===uitzenden;uitzend;uitzende;uitzendt;uitzonde;uitzonden;
ervaren===ervaren;ervaarden;ervare;ervoeren;
dorsten===dorsten;dorst;dorste;dorstte;dorstten;
dimmen===dimmen;
afbreken===afbreken;afbrake;afbraken;afbreek;afbreke;
aanbakken===aanbakken;aanbakke;aanbakte;aanbakten;
verademen===verademen;veradem;verademde;verademden;verademe;verademt;
opduiken===opduiken;opdoken;opduik;opduike;opduikt;
doemen===doemen;doemden;doeme;
kruipen===kruipen;kropen;kruip;kruipe;kruipt;
stijgen===stijgen;stegen;stijg;stijge;stijgt;
binden===binden;binde;bonden;
ontkrachten===ontkrachten;ontkracht;ontkrachte;ontkrachtte;ontkrachtten;
inslapen===inslapen;inslape;insliepen;
vastmaken===vastmaken;vastmaakte;vastmaakten;vastmake;
moorden===moorden;moord;moordde;moordden;moorde;moordt;
ensceneren===ensceneren;ensceneer;ensceneerde;ensceneerden;ensceneert;enscenere;
snuffen===snuffen;
minnen===minnen;minden;minne;
leunen===leunen;leunden;leune;
kwijten===kwijten;kweten;kwijt;kwijte;
dumpen===dumpen;dumpe;dumpten;
bekorten===bekorten;bekort;bekorte;bekortte;bekortten;
verfrissen===verfrissen;verfris;verfrisse;verfrist;verfriste;verfristen;
hurriën===hurriën;hurrie;hurriet;hurrië;
wegvliegen===wegvliegen;wegvlieg;wegvliege;wegvliegt;wegvloge;wegvlogen;
ploffen===ploffen;ploffe;plofte;ploften;
reciteren===reciteren;reciteer;reciteerde;reciteerden;recitere;
zadelen===zadelen;zadel;zadelde;zadelden;zadele;zadelt;
lopen===lopen;lope;
toestaan===toestaan;toesta;toestaat;
benoemen===benoemen;benoem;benoemde;benoemden;benoeme;benoemt;
afpersen===afpersen;afpers;afperse;afperst;afperste;afpersten;
wegsluipen===wegsluipen;wegslope;wegslopen;wegsluip;wegsluipe;wegsluipt;
uitgaan===uitgaan;uitga;uitgaat;
rooien===rooien;rooiden;rooie;
beschaven===beschaven;beschaafden;beschave;
vreemdgaan===vreemdgaan;vreemdga;vreemdgaat;vreemdging;
volhouden===volhouden;volhielden;volhoud;volhoude;volhoudt;
uitproberen===uitproberen;uitprobeer;uitprobeerde;uitprobeerden;uitprobeert;uitprobere;
verleiden===verleiden;verleid;verleidde;verleidden;verleide;verleidt;
verstarren===verstarren;verstar;verstarde;verstarden;verstarre;verstart;
geloven===geloven;gelove;
nablijven===nablijven;nableven;nablijve;
foppen===foppen;foppe;fopten;
voorstellen===voorstellen;voorstel;voorstelde;voorstelden;voorstelle;voorstelt;
inzamelen===inzamelen;inzamel;inzamelde;inzamelden;inzamele;inzamelt;
stampvoeten===stampvoeten;stampvoet;stampvoete;stampvoette;stampvoetten;
vergeten===vergeten;vergate;vergaten;vergeet;vergete;
verrekenen===verrekenen;verreken;verrekende;verrekenden;verrekene;verrekent;
rukken===rukken;rukke;rukten;
belijden===belijden;beleden;belijd;belijde;belijdt;
vousvoyeren===vousvoyeren;vousvoyeer;vousvoyeerde;vousvoyeerden;vousvoyeert;vousvoyere;
vergelen===vergelen;vergeel;vergeelden;vergele;
ontlasten===ontlasten;ontlast;ontlaste;ontlastte;ontlastten;
uitwerpen===uitwerpen;uitwerp;uitwerpe;uitwerpt;uitwierpe;uitwierpen;
glimlachen===glimlachen;glimlach;glimlache;glimlacht;glimlachte;glimlachten;
aantrekken===aantrekken;aantrek;aantrekke;aantrekt;aantrokke;aantrokken;
gelijken===gelijken;geleken;gelijk;gelijke;gelijkt;
ageren===ageren;ageerden;agere;
inklappen===inklappen;inklappe;inklapte;inklapten;
nasynchroniseren===nasynchroniseren;nasynchroniseer;nasynchroniseerde;nasynchroniseerden;nasynchroniseert;nasynchronisere;
behalen===behalen;behaalden;behale;
voeren===voeren;voederen;voerden;voere;
mengen===mengen;mengden;menge;
ontkoppelen===ontkoppelen;ontkoppel;ontkoppelde;ontkoppelden;ontkoppele;ontkoppelt;
voorgaan===voorgaan;voorga;voorgaat;
varen===varen;vaarden;vare;
bevoorrechten===bevoorrechten;bevoorrecht;bevoorrechte;bevoorrechtte;bevoorrechtten;
ontgoochelen===ontgoochelen;ontgoochel;ontgoochelde;ontgoochelden;ontgoochele;ontgoochelt;
opdagen===opdagen;opdaagden;opdage;
schelen===schelen;scheel;scheelden;schele;
zwartrijden===zwartrijden;
vlooien===vlooien;vlooi;vlooide;vlooiden;vlooie;vlooit;
duren===duren;dure;duurden;
zuiveren===zuiveren;zuiver;zuiverde;zuiverden;zuivere;zuivert;
antedateren===antedateren;antedateer;antedateerde;antedateerden;antedateert;antedatere;
pleisteren===pleisteren;pleister;pleisterde;pleisterden;pleistere;pleistert;
zappen===zappen;zapen;zapten;
koperen===koperen;koper;koperde;koperden;kopere;kopert;
wederhalen===wederhalen;wederhaal;wederhaalde;wederhaalden;wederhaalt;wederhale;
inwijden===inwijden;inwijd;inwijdde;inwijdden;inwijde;inwijdt;
kneuzen===kneuzen;kneusden;kneuze;
buizen===buizen;buisden;buize;
snikken===snikken;snikke;snikte;snikten;
zogen===zogen;zoge;zoogden;
verkwikken===verkwikken;verkwik;verkwikke;verkwikt;verkwikte;verkwikten;
opvoeren===opvoeren;opvoer;opvoerde;opvoerden;opvoere;opvoert;
handhaven===handhaven;handhaafden;handhave;
uitlenen===uitlenen;uitleen;uitleenden;uitleent;uitlene;
grenzen===grenzen;grensden;grenze;
inparkeren===inparkeren;inparkeer;inparkeerde;inparkeerden;inparkeert;inparkere;
bekleden===bekleden;beklede;bekleed;bekleedden;
onderdrukken===onderdrukken;onderdruk;onderdrukke;onderdrukt;onderdrukte;onderdrukten;
onthutsen===onthutsen;onthuts;onthutse;onthutst;onthutste;onthutsten;
alpineskiën===alpineskiën;alpineski;alpineskiede;alpineskieden;alpineskiet;alpineskië;
insluipen===insluipen;inslopen;insluip;insluipe;insluipt;
vollopen===vollopen;volliepen;vollope;
liegen===liegen;liege;
ontluiken===ontluiken;ontloken;ontluik;ontluike;ontluikt;
plaatsvinden===plaatsvinden;plaatsvind;plaatsvinde;plaatsvindt;plaatsvond;plaatsvonde;plaatsvonden;plaatsvondt;
jeuken===jeuken;jeuke;jeukten;
opzetten===opzetten;opzette;
verpesten===verpesten;verpest;verpeste;verpestte;verpestten;
besteden===besteden;bestede;besteed;besteedden;
kaarden===kaarden;kaard;kaardde;kaardden;kaarde;kaardt;
ontslaan===ontslaan;ontsla;ontslaat;
balsemen===balsemen;balsem;balsemde;balsemden;balseme;balsemt;
nekken===nekken;nekke;nekten;
desoriënteren===desoriënteren;desoriënteer;desoriënteerde;desoriënteerden;desoriënteert;desoriëntere;
beveiligen===beveiligen;beveilig;beveiligde;beveiligden;beveilige;beveiligt;
betonneren===betonneren;betonneer;betonneerde;betonneerden;betonneert;betonnere;
bassen===bassen;basse;basten;
telen===telen;teelden;tele;
intypen===intypen;intyp;intype;intypt;intypte;intypten;
kunnen===kunnen;kunne;
behelzen===behelzen;behelsden;behelze;
overklokken===overklokken;overklok;overklokke;overklokt;overklokte;overklokten;
verschillen===verschillen;verschil;verschilde;verschilden;verschille;verschilt;
vooruitblikken===vooruitblikken;vooruitblik;vooruitblikke;vooruitblikt;vooruitblikte;vooruitblikten;
minimaliseren===minimaliseren;minimaliseer;minimaliseerde;minimaliseerden;minimaliseert;minimalisere;
persen===persen;perse;persten;
weergeven===weergeven;weergave;weergaven;weergeef;weergeve;
rangschikken===rangschikken;rangschik;rangschikke;rangschikt;rangschikte;rangschikten;
bestijgen===bestijgen;bestegen;bestijg;bestijge;bestijgt;
meebrengen===meebrengen;meebreng;meebrenge;meebrengt;
trommelen===trommelen;trommel;trommelde;trommelden;trommele;trommelt;
opblazen===opblazen;opblaze;opbliezen;
drillen===drillen;drilde;drilden;drille;
weerstaan===weerstaan;weersta;weerstaat;
drijven===drijven;dreven;drijve;
lappen===lappen;lappe;lapten;
doorvertellen===doorvertellen;doorvertel;doorvertelde;doorvertelden;doorvertelle;doorvertelt;
proberen===proberen;probeer;probeerden;probere;
hinderen===hinderen;hinder;hinderde;hinderden;hindere;hindert;
morren===morren;morden;morre;
klinken===klinken;klink;klinke;klinkt;klonke;klonken;
zwijgen===zwijgen;zwegen;zwijg;zwijge;zwijgt;
optellen===optellen;optelde;optelden;optelle;
afwassen===afwassen;afwasse;afwaste;afwasten;
belazeren===belazeren;belazer;belazerde;belazerden;belazere;belazert;
uitvallen===uitvallen;uitvalle;uitvielen;
bijhouden===bijhouden;bijhielden;bijhoud;bijhoude;bijhoudt;
afspreken===afspreken;afsprake;afspraken;afspreek;afspreke;
smakken===smakken;smakke;smakte;smakten;
toekijken===toekijken;toekeken;toekijk;toekijke;toekijkt;
systematiseren===systematiseren;systematiseer;systematiseerde;systematiseerden;systematiseert;systematisere;
spellen===spellen;spelde;spelden;spelle;
ontrollen===ontrollen;ontrolde;ontrolden;ontrolle;
kleineren===kleineren;kleineer;kleineerde;kleineerden;kleinere;
geven===geven;gaven;geve;
doodgaan===doodgaan;doodga;doodgaat;
voordoen===voordoen;voordeden;voordeed;voordoe;voordoet;
kennen===kennen;kenden;kenne;
makken===makken;makke;makten;
knopen===knopen;knoopten;knope;
gedragen===gedragen;gedrage;gedroegen;
vereisen===vereisen;vereis;vereise;vereist;vereiste;vereisten;
ontfutselen===ontfutselen;ontfutsel;ontfutselde;ontfutselden;ontfutsele;ontfutselt;
toedoen===toedoen;toededen;toedeed;toedoe;toedoet;
overvleugelen===overvleugelen;overvleugel;overvleugelde;overvleugelden;overvleugele;overvleugelt;
realiseren===realiseren;realiseer;realiseerde;realiseerden;realiseert;realisere;
noteren===noteren;noteer;noteerden;notere;
aflijven===aflijven;aflijfden;aflijve;
betrekken===betrekken;betrekke;betrokke;betrokken;
uitgraven===uitgraven;uitgrave;uitgroeven;
rondscharrelen===rondscharrelen;rondscharrel;rondscharrelde;rondscharrelden;rondscharrele;rondscharrelt;
memoriseren===memoriseren;memoriseer;memoriseerde;memoriseerden;memoriseert;memorisere;
overwinnen===overwinnen;overwin;overwinne;overwint;overwonne;overwonnen;
verkleuren===verkleuren;verkleur;verkleurde;verkleurden;verkleure;verkleurt;
blinken===blinken;blink;blinke;blinkt;blonke;blonken;
vegen===vegen;vagen;veegden;vege;
aanhitsen===aanhitsen;aanhits;aanhitse;aanhitst;aanhitste;aanhitsten;
baren===baren;baarden;bare;
uitdelgen===uitdelgen;uitdelg;uitdelgde;uitdelgden;uitdelge;uitdelgt;
stuiten===stuiten;stuit;stuite;stuitte;stuitten;
verbannen===verbannen;verbande;verbanden;verbanne;
aangrijpen===aangrijpen;aangrepe;aangrepen;aangrijp;aangrijpe;aangrijpt;
wedijveren===wedijveren;wedijver;wedijverde;wedijverden;wedijvere;wedijvert;
bevlekken===bevlekken;bevlekke;bevlekte;bevlekten;
taxeren===taxeren;taxeer;taxeerden;taxere;
ordenen===ordenen;orden;ordende;ordenden;ordene;ordent;
ontzien===ontzien;ontzagen;ontzie;ontziet;
conserveren===conserveren;conserveer;conserveerde;conserveerden;conserveert;conservere;
inrichten===inrichten;inricht;inrichte;inrichtte;inrichtten;
kaarten===kaarten;kaart;kaarte;kaartte;kaartten;
overblijven===overblijven;overbleve;overbleven;overblijf;overblijft;overblijve;
pendelen===pendelen;pendel;pendelde;pendelden;pendele;pendelt;
creëren===creëren;creëer;creëerden;creëre;
plakken===plakken;plakke;plakte;plakten;
bepleiten===bepleiten;bepleit;bepleite;bepleitte;bepleitten;
klagen===klagen;klaagden;klage;
dagen===dagen;daagden;dage;
neerschrijven===neerschrijven;neerschreve;neerschreven;neerschrijf;neerschrijft;neerschrijve;
verstrikken===verstrikken;verstrik;verstrikke;verstrikt;verstrikte;verstrikten;
uitschakelen===uitschakelen;uitschakel;uitschakelde;uitschakelden;uitschakele;uitschakelt;
verminken===verminken;vermink;verminke;verminkt;verminkte;verminkten;
verdelen===verdelen;verdeel;verdeelden;verdele;
vorsen===vorsen;vorse;vorsten;
vervreemden===vervreemden;vervreemd;vervreemdde;vervreemdden;vervreemde;vervreemdt;
aankloppen===aankloppen;aanklop;aankloppe;aanklopt;aanklopte;aanklopten;
wantrouwen===wantrouwen;wantrouw;wantrouwde;wantrouwden;wantrouwe;wantrouwt;
smuilen===smuilen;smuil;smuilde;smuilden;smuile;smuilt;
beduiden===beduiden;beduid;beduidde;beduidden;beduide;beduidt;
nopen===nopen;noopten;nope;
verdommen===verdommen;verdomde;verdomden;verdomme;
klieven===klieven;klieve;kloven;
inladen===inladen;inlaadden;inlade;
plooien===plooien;plooi;plooide;plooiden;plooie;plooit;
openbaren===openbaren;openbaarde;openbaarden;openbare;
zaligen===zaligen;zalig;zaligde;zaligden;zalige;zaligt;
blazen===blazen;blaze;bliezen;
beetpakken===beetpakken;beetpak;beetpakke;beetpakt;beetpakte;beetpakten;
klokken===klokken;klokke;klokte;klokten;
fokken===fokken;fokke;fokten;
verven===verven;verfden;verve;
sacraliseren===sacraliseren;sacraliseer;sacraliseerde;sacraliseerden;sacraliseert;sacralisere;
schaduwen===schaduwen;schaduw;schaduwde;schaduwden;schaduwe;schaduwt;
vergroten===vergroten;vergrootte;vergrootten;vergrote;
verhogen===verhogen;verhoge;verhoogden;
viseren===viseren;viseer;viseerden;visere;
frituren===frituren;friture;frituurden;
afwikkelen===afwikkelen;afwikkel;afwikkelde;afwikkelden;afwikkele;afwikkelt;
verhandelen===verhandelen;verhandel;verhandelde;verhandelden;verhandele;verhandelt;
stoppen===stoppen;stoppe;stopte;stopten;
komen===komen;kome;kommen;
afzakken===afzakken;afzakke;afzakte;afzakten;
aanvangen===aanvangen;aanvang;aanvange;aanvangt;aanvinge;aanvingen;
matigen===matigen;matig;matigde;matigden;matige;matigt;
hoofdrekenen===hoofdrekenen;
vermoeien===vermoeien;vermoei;vermoeide;vermoeiden;vermoeie;vermoeit;
raven===raven;rave;raveden;ravet;
uitnodigen===uitnodigen;uitnodig;uitnodigde;uitnodigden;uitnodige;uitnodigt;
opleggen===opleggen;oplegde;oplegden;oplegge;
opgeven===opgeven;opgave;opgaven;opgeef;opgeve;
zwellen===zwellen;zwelle;zwolle;zwollen;
believen===believen;beliefden;believe;
opbiepen===opbiepen;opbiep;opbiepe;opbiept;opbiepte;opbiepten;
zuchten===zuchten;zucht;zuchte;zuchtte;zuchtten;
jatten===jatten;jatte;
storen===storen;stoorden;store;
bedwelmen===bedwelmen;bedwelm;bedwelmde;bedwelmden;bedwelme;bedwelmt;
flikkeren===flikkeren;flikker;flikkerde;flikkerden;flikkere;flikkert;
intrigeren===intrigeren;intrigeer;intrigeerde;intrigeerden;intrigeert;intrigere;
proeven===proeven;proefden;proeve;
bedenken===bedenken;bedenk;bedenke;bedenkt;
stranden===stranden;strand;strandde;strandden;strande;strandt;
dragen===dragen;drage;droegen;
valsspelen===valsspelen;valsspeel;valsspeelde;valsspeelden;valsspeelt;valsspele;
aanwinnen===aanwinnen;aanwinne;aanwonne;aanwonnen;
dienen===dienen;dienden;diene;
aflijden===aflijden;
rijten===rijten;rijte;
kleppen===kleppen;kleppe;klepte;klepten;
zweefvliegen===zweefvliegen;zweefvlieg;zweefvliegde;zweefvliegden;zweefvliege;zweefvliegt;
doorgaan===doorgaan;doorga;doorgaat;
opdoemen===opdoemen;opdoem;opdoemde;opdoemden;opdoeme;opdoemt;
tooien===tooien;tooiden;tooie;
infecteren===infecteren;infecteer;infecteerde;infecteerden;infecteert;infectere;
gevangenzetten===gevangenzetten;gevangenzet;gevangenzette;
bezweren===bezweren;bezweer;bezwere;bezwoere;bezwoeren;
gevoelen===gevoelen;gevoel;gevoelde;gevoelden;gevoele;gevoelt;
afkorten===afkorten;afkort;afkorte;afkortte;afkortten;
luieren===luieren;luier;luierde;luierden;luiere;luiert;
nalaten===nalaten;nalate;nalieten;
waarnemen===waarnemen;waarname;waarnamen;waarneem;waarneme;
applaudisseren===applaudisseren;applaudisseer;applaudisseerde;applaudisseerden;applaudisseert;applaudissere;
behouden===behouden;behoud;behoude;behoudt;
kwartetten===kwartetten;kwartet;kwartette;
aanstoten===aanstoten;aanstieten;aanstote;
ploeteren===ploeteren;ploeter;ploeterde;ploeterden;ploetere;ploetert;
flirten===flirten;flirt;flirte;flirtte;flirtten;
luiken===luiken;luike;
vermeerderen===vermeerderen;vermeerder;vermeerderde;vermeerderden;vermeerdere;vermeerdert;
vrijlaten===vrijlaten;vrijlate;vrijlieten;
wegwezen===wegwezen;
afstuderen===afstuderen;afstudeer;afstudeerde;afstudeerden;afstudeert;afstudere;
confirmeren===confirmeren;confirmeer;confirmeerde;confirmeerden;confirmeert;confirmere;
inzitten===inzitten;inzaten;inzitte;
missen===missen;misse;misten;
monsteren===monsteren;monster;monsterde;monsterden;monstere;monstert;
ontkennen===ontkennen;ontkende;ontkenden;ontkenne;
bedroeven===bedroeven;bedroefden;bedroeve;
meegaan===meegaan;meega;meegaat;
knippen===knippen;knippe;knipte;knipten;
aftroeven===aftroeven;aftroefden;aftroeve;
ergeren===ergeren;erger;ergerde;ergerden;ergere;ergert;
bedwingen===bedwingen;bedwing;bedwinge;bedwingt;bedwonge;bedwongen;
categoriseren===categoriseren;categoriseer;categoriseerde;categoriseerden;categoriseert;categorisere;
vastplakken===vastplakken;vastplak;vastplakke;vastplakt;vastplakte;vastplakten;
opleveren===opleveren;oplever;opleverde;opleverden;oplevere;oplevert;
verafschuwen===verafschuwen;verafschuw;verafschuwde;verafschuwden;verafschuwe;verafschuwt;
expanderen===expanderen;expandeer;expandeerde;expandeerden;expandeert;expandere;
participeren===participeren;participeer;participeerde;participeerden;participeert;participere;
vlieden===vlieden;vlied;vliede;vliedt;vloden;
benadelen===benadelen;benadeel;benadeelde;benadeelden;benadele;
spreiden===spreiden;spreid;spreidde;spreidden;spreide;spreidt;
verschonen===verschonen;verschone;verschoon;verschoonde;verschoonden;verschoont;
uitverkopen===uitverkopen;uitverkocht;uitverkochten;uitverkoop;uitverkoopt;uitverkope;
ophouden===ophouden;ophoud;ophoude;ophoudt;
bekijken===bekijken;bekeken;bekijk;bekijke;bekijkt;
starten===starten;start;starte;startte;startten;
verzieken===verzieken;verziek;verzieke;verziekt;verziekte;verziekten;
annoteren===annoteren;annoteer;annoteerde;annoteerden;annotere;
bevredigen===bevredigen;bevredig;bevredigde;bevredigden;bevredige;bevredigt;
ontsnappen===ontsnappen;ontsnap;ontsnappe;ontsnapt;ontsnapte;ontsnapten;
opgaan===opgaan;opgaat;
raden===raden;raadden;rade;
bevoorraden===bevoorraden;bevoorraad;bevoorraadde;bevoorraadden;bevoorraadt;bevoorrade;
verzwakken===verzwakken;verzwak;verzwakke;verzwakt;verzwakte;verzwakten;
pulsen===pulsen;pulse;pulsten;
garen===garen;gaarden;gaderen;gare;
instemmen===instemmen;instemde;instemden;instemme;
computeren===computeren;computer;computerde;computerden;computere;computert;
invoeren===invoeren;invoer;invoerde;invoerden;invoere;invoert;
aanwrijven===aanwrijven;aanwreve;aanwreven;aanwrijf;aanwrijft;aanwrijve;
bevechten===bevechten;bevecht;bevechte;bevochte;bevochten;
bewerkstelligen===bewerkstelligen;bewerkstellig;bewerkstelligde;bewerkstelligden;bewerkstellige;bewerkstelligt;
galvaniseren===galvaniseren;galvaniseer;galvaniseerde;galvaniseerden;galvaniseert;galvanisere;
absorberen===absorberen;absorbeer;absorbeerde;absorbeerden;absorbeert;absorbere;
knutselen===knutselen;knutsel;knutselde;knutselden;knutsele;knutselt;
beamen===beamen;beaamden;beamden;beame;
morrelen===morrelen;morrel;morrelde;morrelden;morrele;morrelt;
onthullen===onthullen;onthulde;onthulden;onthulle;
scheppen===scheppen;scheppe;schepte;schepten;schiepen;
verkopen===verkopen;verkochten;verkope;
richten===richten;richt;richte;richtte;richtten;
betasten===betasten;betast;betaste;betastte;betastten;
kleven===kleven;kleve;
bestoken===bestoken;bestoke;bestookten;
uitlekken===uitlekken;uitlekke;uitlekte;uitlekten;
tippen===tippen;tippe;tipten;
overstromen===overstromen;overstrome;overstroom;overstroomde;overstroomden;overstroomt;
aanbevelen===aanbevelen;aanbeval;aanbevale;aanbevalen;aanbeveel;aanbeveelt;aanbevele;
vermurwen===vermurwen;vermurw;vermurwde;vermurwden;vermurwe;vermurwt;
uitpakken===uitpakken;uitpakke;uitpakte;uitpakten;
kladden===kladden;kladde;
condenseren===condenseren;condenseer;condenseerde;condenseerden;condenseert;condensere;
omitteren===omitteren;omitteer;omitteerde;omitteerden;omittere;
kuipen===kuipen;kuipe;kuipten;
smeren===smeren;smeerden;smere;
opbiechten===opbiechten;opbiecht;opbiechte;opbiechtte;opbiechtten;
terugbrengen===terugbrengen;terugbreng;terugbrenge;terugbrengt;
snellen===snellen;snelde;snelden;snelle;
omzwerven===omzwerven;omzwerve;omzwierve;omzwierven;
beleggen===beleggen;belegde;belegden;belegge;
nagaan===nagaan;nagaat;
hullen===hullen;hulden;hulle;
uitzien===uitzien;uitzagen;uitzie;uitziet;
opdraven===opdraven;opdraafden;opdrave;
gedenken===gedenken;gedenk;gedenke;gedenkt;
dunnen===dunnen;dunden;dunne;
belezen===belezen;belaze;belazen;belees;beleze;
vrijen===vrijen;vrijden;vrije;
auditeren===auditeren;auditeer;auditeerde;auditeerden;auditere;
overwelven===overwelven;overwelf;overwelfde;overwelfden;overwelft;overwelve;
uitlaten===uitlaten;uitlate;uitlieten;
blijken===blijken;bleken;blijk;blijke;blijkt;
redetwisten===redetwisten;redetwist;redetwiste;redetwistte;redetwistten;
opengaan===opengaan;openga;opengaat;
vlechten===vlechten;vlecht;vlechte;vlochte;vlochten;
vergelijken===vergelijken;vergeleke;vergeleken;vergelijk;vergelijke;vergelijkt;
verbranden===verbranden;verbrand;verbrandde;verbrandden;verbrande;verbrandt;
herdenken===herdenken;herdenk;herdenke;herdenkt;
goeden===goeden;goedden;goede;
lesgeven===lesgeven;lesgave;lesgaven;lesgeef;lesgeve;
onderbouwen===onderbouwen;onderbouw;onderbouwde;onderbouwden;onderbouwe;onderbouwt;
begroeten===begroeten;begroet;begroete;begroette;begroetten;
geselen===geselen;gesel;geselde;geselden;gesele;geselt;
evalueren===evalueren;evalueer;evalueerde;evalueerden;evaluere;
boenen===boenen;boenden;boene;
wanen===wanen;waanden;wane;
verteren===verteren;verteer;verteerden;vertere;
grommen===grommen;gromde;gromden;gromme;
wijzen===wijzen;wijze;
nuttigen===nuttigen;nuttig;nuttigde;nuttigden;nuttige;nuttigt;
ziften===ziften;zifte;ziftten;
vastlopen===vastlopen;vastliepen;vastlope;
tarten===tarten;tarte;tartten;
registreren===registreren;registreer;registreerde;registreerden;registreert;registrere;
vertellen===vertellen;vertelde;vertelden;vertelle;
getuigen===getuigen;getuig;getuigde;getuigden;getuige;getuigt;
saneren===saneren;saneer;saneerden;sanere;
opdringen===opdringen;opdring;opdringe;opdringt;opdronge;opdrongen;
onderscheppen===onderscheppen;onderschep;onderscheppe;onderschept;onderschepte;onderschepten;
worstelen===worstelen;worstel;worstelde;worstelden;worstele;worstelt;
ingraven===ingraven;ingrave;ingroeven;
inoculeren===inoculeren;inoculeer;inoculeerde;inoculeerden;inoculeert;inoculere;
verprutsen===verprutsen;verpruts;verprutse;verprutst;verprutste;verprutsten;
emanciperen===emanciperen;emancipeer;emancipeerde;emancipeerden;emancipeert;emancipere;
loodsen===loodsen;loods;loodse;loodst;loodste;loodsten;
roddelen===roddelen;roddel;roddelde;roddelden;roddele;roddelt;
ventileren===ventileren;ventileer;ventileerde;ventileerden;ventileert;ventilere;
wenen===wenen;ween;weenden;wene;
miauwen===miauwen;miauw;miauwde;miauwden;miauwe;miauwt;
verfijnen===verfijnen;verfijn;verfijnde;verfijnden;verfijne;verfijnt;
doorlaten===doorlaten;doorlate;doorlieten;
monteren===monteren;monteer;monteerden;montere;
ontwerpen===ontwerpen;ontwerp;ontwerpe;ontwerpt;ontwierpe;ontwierpen;
refereren===refereren;refereer;refereerde;refereerden;referere;
ontmoedigen===ontmoedigen;ontmoedig;ontmoedigde;ontmoedigden;ontmoedige;ontmoedigt;
injecteren===injecteren;injecteer;injecteerde;injecteerden;injecteert;injectere;
zweven===zweven;zweve;
ontploffen===ontploffen;ontplof;ontploffe;ontploft;ontplofte;ontploften;
doorzoeken===doorzoeken;doorzochten;doorzoek;doorzoeke;doorzoekt;
vastzitten===vastzitten;vastzate;vastzaten;vastzit;vastzitte;
aanstormen===aanstormen;aanstorm;aanstormde;aanstormden;aanstorme;aanstormt;
vestigen===vestigen;vestig;vestigde;vestigden;vestige;vestigt;
meuren===meuren;
slijpen===slijpen;slepen;slijp;slijpe;slijpt;
verkleinen===verkleinen;verklein;verkleinde;verkleinden;verkleine;verkleint;
gvd'en===gvd'en;gvd'den;gvd'e;
voortduren===voortduren;
twijfelen===twijfelen;twijfel;twijfelde;twijfelden;twijfele;twijfelt;
uitdossen===uitdossen;uitdosse;uitdoste;uitdosten;
spuiten===spuiten;spoten;spuit;spuite;
maken===maken;maakten;make;
uitstoten===uitstoten;uitstieten;uitstootte;uitstootten;uitstote;
inspannen===inspannen;inspande;inspanden;inspanne;
manipuleren===manipuleren;manipuleer;manipuleerde;manipuleerden;manipuleert;manipulere;
krimpen===krimpen;krimp;krimpe;krimpt;krompe;krompen;
rellen===rellen;relden;relle;
ontnuchteren===ontnuchteren;ontnuchter;ontnuchterde;ontnuchterden;ontnuchtere;ontnuchtert;
bespotten===bespotten;bespotte;
brokkelen===brokkelen;brokkel;brokkelde;brokkelden;brokkele;brokkelt;
verschaffen===verschaffen;verschaf;verschaffe;verschaft;verschafte;verschaften;
beoordelen===beoordelen;beoordeel;beoordeelde;beoordeelden;beoordeelt;beoordele;
afschaffen===afschaffen;afschaf;afschaffe;afschaft;afschafte;afschaften;
sidderen===sidderen;sidder;sidderde;sidderden;siddere;siddert;
eggen===eggen;egden;egge;
deserteren===deserteren;deserteer;deserteerde;deserteerden;deserteert;desertere;
specialiseren===specialiseren;specialiseer;specialiseerde;specialiseerden;specialiseert;specialisere;
voortkomen===voortkomen;voortkom;voortkome;voortkomt;voortkwame;voortkwamen;
ontstemmen===ontstemmen;ontstem;ontstemde;ontstemden;ontstemme;ontstemt;
dooien===dooien;dooiden;dooie;
kotsen===kotsen;kotse;kotsten;
teruglopen===teruglopen;terugliep;terugliepe;terugliepen;terugloop;terugloopt;teruglope;
motregenen===motregenen;motregen;motregende;motregenden;motregene;motregent;
verharden===verharden;verhard;verhardde;verhardden;verharde;verhardt;
relativeren===relativeren;relativeer;relativeerde;relativeerden;relativeert;relativere;
toepassen===toepassen;toepasse;toepaste;toepasten;
somberen===somberen;
opvoeden===opvoeden;opvoed;opvoedde;opvoedden;opvoede;opvoedt;
schoonmaken===schoonmaken;schoonmaak;schoonmaakt;schoonmaakte;schoonmaakten;schoonmake;
ruiken===ruiken;ruike;
verkoelen===verkoelen;verkoel;verkoelde;verkoelden;verkoele;verkoelt;
wegstoppen===wegstoppen;wegstop;wegstoppe;wegstopt;wegstopte;wegstopten;
pluimen===pluimen;pluim;pluimde;pluimden;pluime;pluimt;
afweren===afweren;afweer;afweerden;afwere;
afhandelen===afhandelen;afhandel;afhandelde;afhandelden;afhandele;afhandelt;
lijnen===lijnen;lijnden;lijne;
impliceren===impliceren;impliceer;impliceerde;impliceerden;impliceert;implicere;
aaneenschakelen===aaneenschakelen;aaneenschakel;aaneenschakelde;aaneenschakelden;aaneenschakele;aaneenschakelt;
klappen===klappen;klappe;klapte;klapten;
dunken===dunken;dunke;dunkten;
yellen===yellen;
kunstschaatsen===kunstschaatsen;kunstschaats;kunstschaatse;kunstschaatst;kunstschaatste;kunstschaatsten;
blenden===blenden;blend;blendde;blendden;blende;blendt;
ontraden===ontraden;ontrade;ontrieden;
rieken===rieken;rieke;
afblazen===afblazen;afblaze;afbliezen;
bogen===bogen;boge;boogden;
overdoen===overdoen;overdeden;overdeed;overdoe;overdoet;
vlotten===vlotten;vlotte;
regenen===regenen;regen;regende;regenden;regene;regent;
bekopen===bekopen;bekope;
liefhebben===liefhebben;liefhadden;liefheb;liefhebbe;liefhebt;
demoduleren===demoduleren;demoduleer;demoduleerde;demoduleerden;demoduleert;demodulere;
tandenpoetsen===tandenpoetsen;tandenpoets;tandenpoetse;tandenpoetst;tandenpoetste;tandenpoetsten;
heropenen===heropenen;heropen;heropende;heropenden;heropene;heropent;
verscheiden===verscheiden;verscheid;verscheidde;verscheidden;verscheide;verscheidt;
dampen===dampen;dampe;dampten;
pijpen===pijpen;pijpe;pijpten;
versmelten===versmelten;versmelt;versmelte;versmeltt;versmolt;versmolte;versmolten;versmoltt;
bannen===bannen;banden;banne;
proppen===proppen;proppe;propte;propten;
afhalen===afhalen;afhaalden;afhale;
voortschrijden===voortschrijden;voortschrede;voortschreden;voortschreed;voortschreedt;voortschrijd;voortschrijde;voortschrijdt;
attesteren===attesteren;attesteer;attesteerde;attesteerden;attesteert;attestere;
formatteren===formatteren;formatteer;formatteerde;formatteerden;formatteert;formattere;
nuanceren===nuanceren;nuanceer;nuanceerde;nuanceerden;nuancere;
vastleggen===vastleggen;vastleg;vastlegde;vastlegden;vastlegge;vastlegt;
verknoeien===verknoeien;verknoei;verknoeide;verknoeiden;verknoeie;verknoeit;
deemoedigen===deemoedigen;deemoedig;deemoedigde;deemoedigden;deemoedige;deemoedigt;
kwaadspreken===kwaadspreken;kwaadsprak;kwaadsprake;kwaadspraken;kwaadspreek;kwaadspreekt;kwaadspreke;
bijstaan===bijstaan;bijsta;bijstaat;
nakomen===nakomen;nakom;nakome;nakomt;nakwamen;
glijden===glijden;gleden;glijd;glijde;glijdt;
verzuilen===verzuilen;verzuil;verzuilde;verzuilden;verzuile;verzuilt;
generaliseren===generaliseren;generaliseer;generaliseerde;generaliseerden;generaliseert;generalisere;
toejuichen===toejuichen;toejuich;toejuiche;toejuicht;toejuichte;toejuichten;
overslaan===overslaan;oversla;overslaat;
uitdijen===uitdijen;uitdij;uitdijde;uitdijden;uitdije;uitdijt;
verplaatsen===verplaatsen;verplaats;verplaatse;verplaatst;verplaatste;verplaatsten;
ontwrichten===ontwrichten;ontwricht;ontwrichte;ontwrichtte;ontwrichtten;
toezeggen===toezeggen;toezegde;toezegden;toezegge;toezeiden;
weeklagen===weeklagen;weeklaagde;weeklaagden;weeklage;
vervallen===vervallen;vervalle;vervielen;
afvuren===afvuren;afvure;afvuurden;
alarmeren===alarmeren;alarmeer;alarmeerde;alarmeerden;alarmere;
symboliseren===symboliseren;symboliseer;symboliseerde;symboliseerden;symboliseert;symbolisere;
lozen===lozen;loze;
overrulen===overrulen;overrule;overrulede;overruleden;overrulet;
verwarren===verwarren;verwarde;verwarden;verwarre;
braken===braken;braakten;brake;
vastbinden===vastbinden;vastbind;vastbinde;vastbindt;vastbond;vastbonde;vastbonden;vastbondt;
omkleden===omkleden;omklede;omkleed;omkleedden;
tegengaan===tegengaan;tegenga;tegengaat;
interveniëren===interveniëren;intervenieer;intervenieerde;intervenieerden;interveniëre;
doelen===doelen;doelden;doele;
borsten===borsten;borst;borste;borstte;borstten;
lonken===lonken;lonke;lonkten;
krabbelen===krabbelen;krabbel;krabbelde;krabbelden;krabbele;krabbelt;
stollen===stollen;stolde;stolden;stolle;
dubbelklikken===dubbelklikken;dubbelklik;dubbelklikke;dubbelklikt;dubbelklikte;dubbelklikten;
botsen===botsen;botse;botsten;
opschepen===opschepen;opscheep;opscheepte;opscheepten;opschepe;
uitpluizen===uitpluizen;uitploze;uitplozen;uitpluis;uitpluisde;uitpluisden;uitpluist;uitpluize;
betonnen===betonnen;betonde;betonden;betonne;
afschuren===afschuren;afschure;afschuurde;afschuurden;
opraken===opraken;opraakten;oprake;
flikflooien===flikflooien;flikflooi;flikflooide;flikflooiden;flikflooie;flikflooit;
aanpakken===aanpakken;aanpakke;aanpakte;aanpakten;
zuipen===zuipen;zuipe;
omwaaien===omwaaien;omwaai;omwaaide;omwaaiden;omwaaie;omwaait;omwoeien;
verkoperen===verkoperen;verkoper;verkoperde;verkoperden;verkopere;verkopert;
perfectioneren===perfectioneren;perfectioneer;perfectioneerde;perfectioneerden;perfectioneert;perfectionere;
losslaan===losslaan;lossla;losslaat;
interviewen===interviewen;interview;interviewde;interviewden;interviewe;interviewt;
lichten===lichten;licht;lichte;lichtte;lichtten;
verhuizen===verhuizen;verhuisden;verhuize;
bloeden===bloeden;bloed;bloedde;bloedden;bloede;bloedt;
peilen===peilen;peilden;peile;
temen===temen;teemden;teme;
chatten===chatten;chatte;
cijferen===cijferen;cijfer;cijferde;cijferden;cijfere;cijfert;
rennen===rennen;renden;renne;
bewijzen===bewijzen;bewezen;bewijze;
verbergen===verbergen;verberg;verberge;verbergt;verborge;verborgen;
gelieven===gelieven;geliefden;gelieve;
betichten===betichten;beticht;betichte;betichtte;betichtten;
verdienen===verdienen;verdien;verdiende;verdienden;verdiene;verdient;
omzetten===omzetten;omzette;
slepen===slepen;sleepten;slepe;
rijen===rijen;rijden;rije;
toelichten===toelichten;toelicht;toelichte;toelichtte;toelichtten;
zingen===zingen;zinge;zongen;
toebijten===toebijten;toebeten;toebijt;toebijte;
tennissen===tennissen;tennisse;tenniste;tennisten;
citeren===citeren;citeer;citeerden;citere;
terugkijken===terugkijken;terugkeke;terugkeken;terugkijk;terugkijke;terugkijkt;
patrouilleren===patrouilleren;patrouilleer;patrouilleerde;patrouilleerden;patrouilleert;patrouillere;
uitflappen===uitflappen;uitflap;uitflappe;uitflapt;uitflapte;uitflapten;
voorafgaan===voorafgaan;voorafga;voorafgaat;voorafging;
omkomen===omkomen;omkom;omkome;omkomt;omkwamen;
bepeinzen===bepeinzen;bepeinsden;bepeinze;
roepen===roepen;riepen;roepe;
lekken===lekken;lekke;lekten;
liggen===liggen;ligge;
afmotten===afmotten;afmotte;
spierversterken===spierversterken;
tussenwerpen===tussenwerpen;tussenwerp;tussenwerpe;tussenwerpt;tussenwierp;tussenwierpe;tussenwierpen;tussenwierpt;
vernietigen===vernietigen;vernietig;vernietigde;vernietigden;vernietige;vernietigt;
wegwerken===wegwerken;wegwerk;wegwerke;wegwerkt;wegwerkte;wegwerkten;
lijden===lijden;lijde;
schiften===schiften;schift;schifte;schiftte;schiftten;
ontlenen===ontlenen;ontleen;ontleenden;ontleent;ontlene;
overnachten===overnachten;overnacht;overnachte;overnachtte;overnachtten;
luizen===luizen;luisden;luize;
verdedigen===verdedigen;verdedig;verdedigde;verdedigden;verdedige;verdedigt;
veinzen===veinzen;veinsden;veinze;
afraden===afraden;afraadden;afrade;afrieden;
kalmeren===kalmeren;kalmeer;kalmeerden;kalmere;
verdwijnen===verdwijnen;verdween;verdwene;verdwenen;verdwijn;verdwijne;verdwijnt;
aanzien===aanzien;aanzagen;aanzie;aanziet;
gooien===gooien;gooiden;gooie;
zinnigen===zinnigen;zinnig;zinnigde;zinnigden;zinnige;zinnigt;
hollen===hollen;holden;holle;
disputeren===disputeren;disputeer;disputeerde;disputeerden;disputeert;disputere;
ontvreemden===ontvreemden;ontvreemd;ontvreemdde;ontvreemdden;ontvreemde;ontvreemdt;
wringen===wringen;wring;wringe;wringt;wronge;wrongen;
waarborgen===waarborgen;waarborg;waarborgde;waarborgden;waarborge;waarborgt;
vervaardigen===vervaardigen;vervaardig;vervaardigde;vervaardigden;vervaardige;vervaardigt;
steigeren===steigeren;steiger;steigerde;steigerden;steigere;steigert;
peinzen===peinzen;peinsden;peinze;
uitroepen===uitroepen;uitriepe;uitriepen;uitroep;uitroepe;uitroept;
leerlooien===leerlooien;leerlooi;leerlooide;leerlooiden;leerlooie;leerlooit;
omlopen===omlopen;omliepen;omlope;
wetgeven===wetgeven;
sudderen===sudderen;sudder;sudderde;sudderden;suddere;suddert;
toveren===toveren;tover;toverde;toverden;tovere;tovert;
verzuimen===verzuimen;verzuim;verzuimde;verzuimden;verzuime;verzuimt;
herwinnen===herwinnen;herwinne;herwonne;herwonnen;
zuigen===zuigen;zuige;
optimaliseren===optimaliseren;optimaliseer;optimaliseerde;optimaliseerden;optimaliseert;optimalisere;
toebrengen===toebrengen;toebreng;toebrenge;toebrengt;
verloven===verloven;verloofden;verlove;
waaieren===waaieren;waaier;waaierde;waaierden;waaiere;waaiert;
biologeren===biologeren;biologeer;biologeerde;biologeerden;biologeert;biologere;
voortvaren===voortvaren;voortvaar;voortvaart;voortvare;voortvoer;voortvoere;voortvoeren;
verontschuldigen===verontschuldigen;verontschuldig;verontschuldigde;verontschuldigden;verontschuldige;verontschuldigt;
werken===werken;werke;werkten;
sluizen===sluizen;sluisden;sluize;
verklaren===verklaren;verklaarde;verklaarden;verklare;
aangaan===aangaan;aanga;aangaat;
verguizen===verguizen;verguisden;verguize;
verstrijken===verstrijken;verstreke;verstreken;verstrijk;verstrijke;verstrijkt;
lossen===lossen;losse;losten;
stotteren===stotteren;stotter;stotterde;stotterden;stottere;stottert;
spetteren===spetteren;spetter;spetterde;spetterden;spettere;spettert;
verkitten===verkitten;verkitte;
kieken===kieken;kieke;kiekten;
verzamelen===verzamelen;verzamel;verzamelde;verzamelden;verzamele;verzamelt;
besterven===besterven;besterve;bestierve;bestierven;
industrialiseren===industrialiseren;industrialiseer;industrialiseerde;industrialiseerden;industrialiseert;industrialisere;
houwen===houwen;hieuwen;houwden;houwe;
beantwoorden===beantwoorden;beantwoord;beantwoordde;beantwoordden;beantwoorde;beantwoordt;
genereren===genereren;genereer;genereerde;genereerden;generere;
vragen===vragen;vraagden;vrage;vroegen;
plunderen===plunderen;plunder;plunderde;plunderden;plundere;plundert;
veranderen===veranderen;verander;veranderde;veranderden;verandere;verandert;
verwachten===verwachten;verwacht;verwachte;verwachtte;verwachtten;
staken===staken;staakten;stake;
uittrekken===uittrekken;uittrek;uittrekke;uittrekt;uittrokke;uittrokken;
uitkuren===uitkuren;uitkure;uitkuurden;
benijden===benijden;beneden;benijd;benijdde;benijdden;benijde;benijdt;
kwijnen===kwijnen;kwijn;kwijnde;kwijnden;kwijne;kwijnt;
vernaaien===vernaaien;vernaai;vernaaide;vernaaiden;vernaaie;vernaait;
woeden===woeden;woedden;woede;
zonnen===zonnen;zonden;zonne;
wervelen===wervelen;wervel;wervelde;wervelden;wervele;wervelt;
stinken===stinken;stink;stinke;stinkt;stonke;stonken;
logeren===logeren;logeer;logeerden;logere;
thuiskomen===thuiskomen;thuiskom;thuiskome;thuiskomt;thuiskwame;thuiskwamen;
verbijsteren===verbijsteren;verbijster;verbijsterde;verbijsterden;verbijstere;verbijstert;
beroeren===beroeren;beroer;beroerde;beroerden;beroere;beroert;
voleindigen===voleindigen;voleindig;voleindigde;voleindigden;voleindige;voleindigt;
verpieteren===verpieteren;verpieter;verpieterde;verpieterden;verpietere;verpietert;
inboeten===inboeten;inboet;inboete;inboette;inboetten;
experimenteren===experimenteren;experimenteer;experimenteerde;experimenteerden;experimenteert;experimentere;
twinkelen===twinkelen;twinkel;twinkelde;twinkelden;twinkele;twinkelt;
feliciteren===feliciteren;feliciteer;feliciteerde;feliciteerden;feliciteert;felicitere;
appreciëren===appreciëren;
beschimpen===beschimpen;beschimp;beschimpe;beschimpt;beschimpte;beschimpten;
vrijpleiten===vrijpleiten;vrijpleit;vrijpleite;vrijpleitte;vrijpleitten;
ontdekken===ontdekken;ontdekke;ontdekte;ontdekten;
luchten===luchten;lucht;luchte;luchtte;luchtten;
voordragen===voordragen;voordraag;voordraagt;voordrage;voordroeg;voordroege;voordroegen;
vrijmaken===vrijmaken;vrijmaakte;vrijmaakten;vrijmake;
toewensen===toewensen;toewens;toewense;toewenst;toewenste;toewensten;
lijmen===lijmen;lijmden;lijme;
seinen===seinen;seinden;seine;
verkassen===verkassen;verkasse;verkaste;verkasten;
ontzilten===ontzilten;ontzilt;ontzilte;ontziltte;ontziltten;
begiftigen===begiftigen;begiftig;begiftigde;begiftigden;begiftige;begiftigt;
ademhalen===ademhalen;ademhaalde;ademhaalden;ademhale;
vrijgeven===vrijgeven;vrijgave;vrijgaven;vrijgeef;vrijgeve;
piekdrinken===piekdrinken;
wroeten===wroeten;wroet;wroete;wroette;wroetten;
fietsen===fietsen;fiets;fietse;fietst;fietste;fietsten;
uitstaan===uitstaan;uitsta;uitstaat;
verordonneren===verordonneren;verordonneer;verordonneerde;verordonneerden;verordonneert;verordonnere;
inpeperen===inpeperen;
berusten===berusten;berust;beruste;berustte;berustten;
uitrichten===uitrichten;uitricht;uitrichte;uitrichtte;uitrichtten;
ruwen===ruwen;ruwden;ruwe;
vullen===vullen;vulden;vulle;
aansporen===aansporen;aanspoorde;aanspoorden;aanspore;
verheugen===verheugen;verheug;verheugde;verheugden;verheuge;verheugt;
verorberen===verorberen;verorber;verorberde;verorberden;verorbere;verorbert;
logen===logen;loge;loogden;
publiceren===publiceren;publiceer;publiceerde;publiceerden;publiceert;publicere;
freineren===freineren;
piekeren===piekeren;
zenden===zenden;zende;zonden;
nadoen===nadoen;nadeden;nadoe;nadoet;
uitbreiden===uitbreiden;uitbreid;uitbreidde;uitbreidden;uitbreide;uitbreidt;
demonstreren===demonstreren;demonstreer;demonstreerde;demonstreerden;demonstreert;demonstrere;
scheren===scheren;scheer;scheerden;schere;schore;schoren;
aanleveren===aanleveren;aanlever;aanleverde;aanleverden;aanlevere;aanlevert;
ontspannen===ontspannen;ontspan;ontspande;ontspanden;ontspanne;ontspant;
verlieven===verlieven;verliefden;verlieve;
verbloemen===verbloemen;verbloem;verbloemde;verbloemden;verbloeme;verbloemt;
moeten===moeten;moesten;moete;
uitpuilen===uitpuilen;uitpuil;uitpuilde;uitpuilden;uitpuile;uitpuilt;
bezitten===bezitten;bezaten;bezitte;
verkrijgen===verkrijgen;verkrege;verkregen;verkrijg;verkrijge;verkrijgt;
stuiven===stuiven;stoven;stuive;
pezen===pezen;peze;
misten===misten;miste;mistten;
walgen===walgen;walgden;walge;
aanstaren===aanstaren;aanstaarde;aanstaarden;aanstare;
voltooien===voltooien;voltooi;voltooide;voltooiden;voltooie;voltooit;
willen===willen;wilden;wille;
verlangen===verlangen;verlang;verlangde;verlangden;verlange;verlangt;
afzetten===afzetten;afzette;
respecteren===respecteren;respecteer;respecteerde;respecteerden;respecteert;respectere;
bewaaren===bewaaren;
verzwinden===verzwinden;verzwind;verzwinde;verzwindt;verzwond;verzwonde;verzwonden;verzwondt;
voorkomen===voorkomen;voorkom;voorkome;voorkomt;voorkwamen;
hardlopen===hardlopen;hardliepen;hardlope;
ontkleden===ontkleden;ontkleed;ontkleedde;ontkleedden;ontkleede;ontkleeden;
aanhouden===aanhouden;aanhielden;aanhoud;aanhoude;aanhoudt;
besmeuren===besmeuren;besmeur;besmeurde;besmeurden;besmeure;besmeurt;
beweren===beweren;beweer;beweerden;bewere;
sneeuwen===sneeuwen;sneeuw;sneeuwde;sneeuwden;sneeuwe;sneeuwt;
metamorfoseren===metamorfoseren;metamorfoseer;metamorfoseerde;metamorfoseerden;metamorfoseert;metamorfosere;
toenemen===toenemen;toename;toenamen;toeneem;toeneme;
calibreren===calibreren;
schijnen===schijnen;schenen;schijn;schijne;schijnt;
napraten===napraten;napraatten;naprate;
dompelen===dompelen;dompel;dompelde;dompelden;dompele;dompelt;
tuiten===tuiten;tuite;tuitten;
verschieten===verschieten;verschiet;verschiete;verschote;verschoten;
denken===denken;denke;
afsluiten===afsluiten;afsloten;afsluit;afsluite;
schrinken===schrinken;
grienen===grienen;grien;griende;grienden;griene;grient;
verstrammen===verstrammen;verstram;verstramde;verstramden;verstramme;verstramt;
sterven===sterven;sterve;stierve;stierven;
scheuren===scheuren;scheur;scheurde;scheurden;scheure;scheurt;
verbreden===verbreden;verbrede;verbreed;verbreedde;verbreedden;
afbakenen===afbakenen;afbaken;afbakende;afbakenden;afbakene;afbakent;
koppelen===koppelen;koppel;koppelde;koppelden;koppele;koppelt;
afslachten===afslachten;afslacht;afslachte;afslachtte;afslachtten;
uitoefenen===uitoefenen;uitoefen;uitoefende;uitoefenden;uitoefene;uitoefent;
exciteren===exciteren;exciteer;exciteerde;exciteerden;excitere;
ronddraven===ronddraven;ronddraaf;ronddraafden;ronddraaft;ronddrave;
rouwen===rouwen;rouwden;rouwe;
deelnemen===deelnemen;deelname;deelnamen;deelneem;deelneme;
claimen===claimen;claim;claimde;claimden;claime;claimt;
betrouwen===betrouwen;betrouw;betrouwde;betrouwden;betrouwe;betrouwt;
speuren===speuren;speur;speurde;speurden;speure;speurt;
afleveren===afleveren;aflever;afleverde;afleverden;aflevere;aflevert;
aanscherpen===aanscherpen;aanscherp;aanscherpe;aanscherpt;aanscherpte;aanscherpten;
genezen===genezen;genaze;genazen;genees;geneze;
ruziën===ruziën;ruzië;
baseren===baseren;baseer;baseerden;basere;
debuteren===debuteren;debuteer;debuteerde;debuteerden;debutere;
faxen===faxen;faxe;faxten;
schelden===schelden;scheld;schelde;scheldt;scholde;scholden;
beraadslagen===beraadslagen;beraadslaag;beraadslaagde;beraadslaagden;beraadslaagt;beraadslage;
verglijden===verglijden;verglede;vergleden;verglijd;verglijde;verglijdt;
vijzen===vijzen;vijze;
glaceren===glaceren;glaceer;glaceerden;glacere;
tippelen===tippelen;tippel;tippelde;tippelden;tippele;tippelt;
aanvreten===aanvreten;aanvrate;aanvraten;aanvreet;aanvrete;
ramen===ramen;raamden;rame;
wrikken===wrikken;wrikke;wrikte;wrikten;
blaren===blaren;blaarden;blare;
vergelden===vergelden;vergeld;vergelde;vergeldt;vergolde;vergolden;
ontspruiten===ontspruiten;ontsprote;ontsproten;ontspruit;ontspruite;
protegeren===protegeren;protegeer;protegeerde;protegeerden;protegeert;protegere;
bliksemen===bliksemen;bliksem;bliksemde;bliksemden;blikseme;bliksemt;
ondertekenen===ondertekenen;onderteken;ondertekende;ondertekenden;ondertekene;ondertekent;
bekeuren===bekeuren;bekeur;bekeurde;bekeurden;bekeure;bekeurt;
aanroeren===aanroeren;aanroer;aanroerde;aanroerden;aanroere;aanroert;
aansluiten===aansluiten;aanslote;aansloten;aansluit;aansluite;
uitstorten===uitstorten;uitstort;uitstorte;uitstortte;uitstortten;
dynamiteren===dynamiteren;dynamiteer;dynamiteerde;dynamiteerden;dynamiteert;dynamitere;
belemmeren===belemmeren;belemmer;belemmerde;belemmerden;belemmere;belemmert;
