ca===ca;
pues===pues;
donde===donde;
pero===pero;
conque===conque;
siquiera===siquiera;
q̃===q̃;
porque===porque;
que===que;
mas===mas;
e===e;
&===&;
ya===ya;
ergo===ergo;
o===o;
entonces===entonces;
sino===sino;
i===i;
ahora===ahora;
si===si;
u===u;
ú===ú;
cuando===cuando;quando;
aunque===aunque;
puesto===puesto;
mientras===mientras;
ni===ni;
ó===ó;
sii===sii;
y===y;
