dittatoriamente===dittatoriamente;
irrefragabilmente===irrefragabilmente;
lievamente===lievamente;
generazionalmente===generazionalmente;
imperiosamente===imperiosamente;
mutabilmente===mutabilmente;
timidamente===timidamente;
disparatamente===disparatamente;
altrove===altrove;
gustosamente===gustosamente;
canonicamente===canonicamente;
tristemente===tristemente;
cautamente===cautamente;
tollerabilmente===tollerabilmente;
granfatto===granfatto;
astrologicamente===astrologicamente;
destramente===destramente;
dabbasso===dabbasso;
+===+;
compuntamente===compuntamente;
asintoticamente===asintoticamente;
flessibilmente===flessibilmente;
bruttamente===bruttamente;
necessariamente===necessariamente;
encliticamente===encliticamente;
orecchiabilmente===orecchiabilmente;
coercitivamente===coercitivamente;
interiormente===interiormente;
esplicitamente===esplicitamente;
congiuntamente===congiuntamente;
doviziosamente===doviziosamente;
dirottamente===dirottamente;
inespugnabilmente===inespugnabilmente;
bonariamente===bonariamente;
laidamente===laidamente;
usitatamente===usitatamente;
guari===guari;
empiamente===empiamente;
cattedraticamente===cattedraticamente;
congruentemente===congruentemente;
ingarbugliatamente===ingarbugliatamente;
possibilmente===possibilmente;
tenuamente===tenuamente;
vittoriosamente===vittoriosamente;
dozzinalmente===dozzinalmente;
inelasticamente===inelasticamente;
asessualmente===asessualmente;
eversivamente===eversivamente;
controcorrente===controcorrente;
impensatamente===impensatamente;
maccheronicamente===maccheronicamente;
cortesemente===cortesemente;
eroicamente===eroicamente;
irriconoscibilmente===irriconoscibilmente;
grafologicamente===grafologicamente;
esattamente===esattamente;
ininterrottamente===ininterrottamente;
indomabilmente===indomabilmente;
avvilentemente===avvilentemente;
dignitosamente===dignitosamente;
barbaricamente===barbaricamente;
insaziabilmente===insaziabilmente;
socievolmente===socievolmente;
fonicamente===fonicamente;
abilmente===abilmente;
bambinescamente===bambinescamente;
obbligatamente===obbligatamente;
psicanaliticamente===psicanaliticamente;
sdruccioloni===sdruccioloni;
dinoccolatamente===dinoccolatamente;
qualitativamente===qualitativamente;
dietro===dietro;
burocraticamente===burocraticamente;
manco===manco;
obbiettivamente===obbiettivamente;
emozionalmente===emozionalmente;
appena===appena;
linguisticamente===linguisticamente;
smorzando===smorzando;
corroborantemente===corroborantemente;
inattendibilmente===inattendibilmente;
compostamente===compostamente;
ciondolone===ciondolone;
assai===assai;
ciondoloni===ciondoloni;
animatamente===animatamente;
maliosamente===maliosamente;
tanto===tanto;
inseparabilmente===inseparabilmente;
quotidianamente===quotidianamente;
nauseosamente===nauseosamente;
aggressivamente===aggressivamente;
bassamente===bassamente;
rudemente===rudemente;
ritmicamente===ritmicamente;
sospettosamente===sospettosamente;
eccepibilmente===eccepibilmente;
certamente===certamente;
viepiù===viepiù;
efficacemente===efficacemente;
infine===infine;
insulsamente===insulsamente;
lentamente===lentamente;
svisceratamente===svisceratamente;
irrispettosamente===irrispettosamente;
pungentemente===pungentemente;
passionalmente===passionalmente;
parallelamente===parallelamente;
penosamente===penosamente;
rumorosamente===rumorosamente;
attualmente===attualmente;
dannatamente===dannatamente;
femminilmente===femminilmente;
arcadicamente===arcadicamente;
dualisticamente===dualisticamente;
animosamente===animosamente;
probabilmente===probabilmente;
conforme===conforme;
oralmente===oralmente;
estremamente===estremamente;
platonicamente===platonicamente;
affermativamente===affermativamente;
professionalmente===professionalmente;
inconfessabilmente===inconfessabilmente;
intuitivamente===intuitivamente;
incurabilmente===incurabilmente;
validamente===validamente;
supinamente===supinamente;
meno===meno;men;
crudamente===crudamente;
solamente===solamente;
sostantivamente===sostantivamente;
produttivamente===produttivamente;
noncurantemente===noncurantemente;
confacentemente===confacentemente;
mensilmente===mensilmente;
militarescamente===militarescamente;
ostilmente===ostilmente;
profeticamente===profeticamente;
sentimentalmente===sentimentalmente;
dopocena===dopocena;
familiarmente===familiarmente;
invidiabilmente===invidiabilmente;
claustrofobicamente===claustrofobicamente;
problematicamente===problematicamente;
basicamente===basicamente;
occultamente===occultamente;
pedagogicamente===pedagogicamente;
libidinosamente===libidinosamente;
operativamente===operativamente;
ineffabilmente===ineffabilmente;
lordamente===lordamente;
occultamento===occultamento;
magicamente===magicamente;
militarmente===militarmente;
sterilmente===sterilmente;
sostanzialmente===sostanzialmente;
oggettivamente===oggettivamente;
deontologicamente===deontologicamente;
singolarmente===singolarmente;
unicameralmente===unicameralmente;
variamente===variamente;
accanto===accanto;
psichiatricamente===psichiatricamente;
proporzionalmente===proporzionalmente;
sperabilmente===sperabilmente;
caoticamente===caoticamente;
indignatamente===indignatamente;
botanicamente===botanicamente;
disunitamente===disunitamente;
tatticamente===tatticamente;
curialescamente===curialescamente;
stagionalmente===stagionalmente;
distesamente===distesamente;
fotomeccanicamente===fotomeccanicamente;
temporalmente===temporalmente;
mutevolmente===mutevolmente;
psicopatologicamente===psicopatologicamente;
militaristicamente===militaristicamente;
sobriamente===sobriamente;
oscuramente===oscuramente;
insipidamente===insipidamente;
malvolentieri===malvolentieri;
irrinunciabilmente===irrinunciabilmente;
arrogantemente===arrogantemente;
caldamente===caldamente;
gaiamente===gaiamente;
statisticamente===statisticamente;
malaugurosamente===malaugurosamente;
piamente===piamente;
disattentamente===disattentamente;
mestamente===mestamente;
vaginalmente===vaginalmente;
sfortunatamente===sfortunatamente;
fortuitamente===fortuitamente;
negligentemente===negligentemente;
idealisticamente===idealisticamente;
freddamente===freddamente;
malcautamente===malcautamente;
risolutivamente===risolutivamente;
inespressivamente===inespressivamente;
incomparabilmente===incomparabilmente;
indecentemente===indecentemente;
momentaneamente===momentaneamente;
misantropicamente===misantropicamente;
ginocchioni===ginocchioni;
anonimamente===anonimamente;
ambientalmente===ambientalmente;
ferocemente===ferocemente;
sinergicamente===sinergicamente;
veracemente===veracemente;
riprensibilmente===riprensibilmente;
lodevolmente===lodevolmente;
difensivamente===difensivamente;
arrendevolmente===arrendevolmente;
garbatamente===garbatamente;
sventatamente===sventatamente;
basso===basso;
liquidamente===liquidamente;
cica===cica;
dannosamente===dannosamente;
epigraficamente===epigraficamente;
realmente===realmente;
inimitabilmente===inimitabilmente;
rozzamente===rozzamente;
scarsamente===scarsamente;
testé===testé;
abulicamente===abulicamente;
cadenzatamente===cadenzatamente;
perennemente===perennemente;
onestamente===onestamente;
iernotte===iernotte;
grandemente===grandemente;
obiettivamente===obiettivamente;
impossibilmente===impossibilmente;
epigrammaticamente===epigrammaticamente;
incresciosamente===incresciosamente;
mellifluamente===mellifluamente;
inintelligibilmente===inintelligibilmente;
difficilmente===difficilmente;
immancabilmente===immancabilmente;
disciplinatamente===disciplinatamente;
inconsapevolmente===inconsapevolmente;
malauguratamente===malauguratamente;
inaffidabilmente===inaffidabilmente;
insieme===insieme;insiem;
tormentosamente===tormentosamente;
narrativamente===narrativamente;
carnalmente===carnalmente;
moralisticamente===moralisticamente;
idillicamente===idillicamente;
verosimilmente===verosimilmente;
gesuiticamente===gesuiticamente;
fattibilmente===fattibilmente;
architettonicamente===architettonicamente;
guardingamente===guardingamente;
clinicamente===clinicamente;
sproporzionatamente===sproporzionatamente;
imprenditorialmente===imprenditorialmente;
intimisticamente===intimisticamente;
impresentabilmente===impresentabilmente;
valorosamente===valorosamente;
irremissibilmente===irremissibilmente;
incazzosamente===incazzosamente;
lepidamente===lepidamente;
vantaggiosamente===vantaggiosamente;
indistruttibilmente===indistruttibilmente;
comparativamente===comparativamente;
pletoricamente===pletoricamente;
preventivamente===preventivamente;
matrimonialmente===matrimonialmente;
lusinghevolmente===lusinghevolmente;
diurnamente===diurnamente;
melodiosamente===melodiosamente;
corrispettivamente===corrispettivamente;
biecamente===biecamente;
continuativamente===continuativamente;
sontuosamente===sontuosamente;
malvolontieri===malvolontieri;
dottamente===dottamente;
bardosso===bardosso;
anatomicamente===anatomicamente;
fatuamente===fatuamente;
finora===finora;finor;
campanilisticamente===campanilisticamente;
fanciullescamente===fanciullescamente;
irrequietamente===irrequietamente;
aprioristicamente===aprioristicamente;
ivi===ivi;
sopra===sopra;
sottotono===sottotono;
sciattamente===sciattamente;
artisticamente===artisticamente;
spettroscopicamente===spettroscopicamente;
telegraficamente===telegraficamente;
saltuariamente===saltuariamente;
magramente===magramente;
procellosamente===procellosamente;
davvero===davvero;
nascostamente===nascostamente;
vezzosamente===vezzosamente;
inescusabilmente===inescusabilmente;
latitudinalmente===latitudinalmente;
meramente===meramente;
effemminatamente===effemminatamente;
immarcescibilmente===immarcescibilmente;
incredibilmente===incredibilmente;
bestialmente===bestialmente;
ciclicamente===ciclicamente;
sopportabilmente===sopportabilmente;
scambievolmente===scambievolmente;
specularmente===specularmente;
sopraccoperta===sopraccoperta;
asceticamente===asceticamente;
parecchio===parecchio;
intattamente===intattamente;
azzardosamente===azzardosamente;
festosamente===festosamente;
usualmente===usualmente;
allineatamente===allineatamente;
psicologicamente===psicologicamente;
ascensionalmente===ascensionalmente;
cordialmente===cordialmente;
sgarbatamente===sgarbatamente;
fanaticamente===fanaticamente;
minimamente===minimamente;menomamente;
intellettualmente===intellettualmente;
codardamente===codardamente;
nefariamente===nefariamente;
disparte===disparte;
prestigiosamente===prestigiosamente;
obliquamente===obliquamente;
infallibilmente===infallibilmente;
inconcepibilmente===inconcepibilmente;
indifferentemente===indifferentemente;
tacitamente===tacitamente;
piccosamente===piccosamente;
maleficamente===maleficamente;
disgraziatamente===disgraziatamente;
insostenibilmente===insostenibilmente;
bisdosso===bisdosso;
appassionatamente===appassionatamente;
inosservabilmente===inosservabilmente;
improduttivamente===improduttivamente;
controvertibilmente===controvertibilmente;
perentoriamente===perentoriamente;
calligraficamente===calligraficamente;
noiosamente===noiosamente;
trivialmente===trivialmente;
solo===solo;
contingentemente===contingentemente;
sgangheratamente===sgangheratamente;
perpendicolarmente===perpendicolarmente;
ecco===ecco;
acutamente===acutamente;
integerrimamente===integerrimamente;
oltrecortina===oltrecortina;
assordantemente===assordantemente;
fieramente===fieramente;
puristicamente===puristicamente;
imperturbabilmente===imperturbabilmente;
proditoriamente===proditoriamente;
talvolta===talvolta;
indefessamente===indefessamente;
stupidamente===stupidamente;
convintamente===convintamente;
piratescamente===piratescamente;
occidentalmente===occidentalmente;
all'incirca===all'incirca;
propriamente===propriamente;
benignamente===benignamente;
incomunicabilmente===incomunicabilmente;
disonorevolmente===disonorevolmente;
incomprimibilmente===incomprimibilmente;
irremovibilmente===irremovibilmente;
fallosamente===fallosamente;
acerbamente===acerbamente;
caratterialmente===caratterialmente;
mentalmente===mentalmente;
agrestemente===agrestemente;
sguaiatamente===sguaiatamente;
pregevolmente===pregevolmente;
sensazionalmente===sensazionalmente;
insospettatamente===insospettatamente;
draconianamente===draconianamente;
cavernosamente===cavernosamente;
distrattamente===distrattamente;
sospensivamente===sospensivamente;
irriverentemente===irriverentemente;
assolutisticamente===assolutisticamente;
transitoriamente===transitoriamente;
clericalmente===clericalmente;
chetamente===chetamente;
indulgentemente===indulgentemente;
rincrescevolmente===rincrescevolmente;
nuovamente===nuovamente;
all'insù===all'insù;
distintamente===distintamente;
teoricamente===teoricamente;
regionalmente===regionalmente;
esizialmente===esizialmente;
tastoni===tastoni;
fonologicament===fonologicament;
basalmente===basalmente;
sottozero===sottozero;
istologicamente===istologicamente;
memorabilmente===memorabilmente;
sfuggevolmente===sfuggevolmente;
quantomeno===quantomeno;
perpetuamente===perpetuamente;
schifosamente===schifosamente;
riservatamente===riservatamente;
estrosamente===estrosamente;
esaurientemente===esaurientemente;
stilisticamente===stilisticamente;
mefistofelicamente===mefistofelicamente;
appositamente===appositamente;
provvisoriamente===provvisoriamente;
apologeticamente===apologeticamente;
chirurgicamente===chirurgicamente;
stanotte===stanotte;
antiquatamente===antiquatamente;
agnosticamente===agnosticamente;
floridamente===floridamente;
esegeticamente===esegeticamente;
egocentricamente===egocentricamente;
propiziamente===propiziamente;
gigantescamente===gigantescamente;
accesamente===accesamente;
giammai===giammai;
ironicamente===ironicamente;
paradossalmente===paradossalmente;
venalmente===venalmente;
urbanisticamente===urbanisticamente;
osticamente===osticamente;
selettivamente===selettivamente;
sonoramente===sonoramente;
dolosamente===dolosamente;
incompiutamente===incompiutamente;
irrecusabilmente===irrecusabilmente;
scostumatamente===scostumatamente;
volutamente===volutamente;
cedevolmente===cedevolmente;
insomma===insomma;
ecumenicamente===ecumenicamente;
embriologicamente===embriologicamente;
abbagliatamente===abbagliatamente;
intelligibilmente===intelligibilmente;
astutamente===astutamente;
abantico===abantico;
unanimemente===unanimemente;
attonitamente===attonitamente;
microscopicamente===microscopicamente;
indubitabilmente===indubitabilmente;
irresponsabilmente===irresponsabilmente;
metonimicamente===metonimicamente;
sinteticamente===sinteticamente;
ingegnosamente===ingegnosamente;
lascivamente===lascivamente;
teologicamente===teologicamente;
intraprendentemente===intraprendentemente;
alacramente===alacramente;
storditamente===storditamente;
snaturatamente===snaturatamente;
interminatamente===interminatamente;
immaginariamente===immaginariamente;
innocentemente===innocentemente;
debitamente===debitamente;
precipuamente===precipuamente;
misticamente===misticamente;
melodicamente===melodicamente;
asetticamente===asetticamente;
disperatamente===disperatamente;
anastaticamente===anastaticamente;
aderentemente===aderentemente;
malaccortamente===malaccortamente;
stancamente===stancamente;
insistentemente===insistentemente;
preferenzialmente===preferenzialmente;
manieristicamente===manieristicamente;
sanabilmente===sanabilmente;
riccamente===riccamente;
utilmente===utilmente;
elasticamente===elasticamente;
incontrovertibilmente===incontrovertibilmente;
franco===franco;
untuosamente===untuosamente;
chiassosamente===chiassosamente;
innegabilmente===innegabilmente;
scenicamente===scenicamente;
assettatamente===assettatamente;
odiosamente===odiosamente;
imprevidentemente===imprevidentemente;
frattanto===frattanto;
ineccepibilmente===ineccepibilmente;
giustamente===giustamente;
mefiticamente===mefiticamente;
dispendiosamente===dispendiosamente;
inaspettatamente===inaspettatamente;
identicamente===identicamente;
indesideratamente===indesideratamente;
alfabeticamente===alfabeticamente;
disonestamente===disonestamente;
diacronicamente===diacronicamente;
riprovevolmente===riprovevolmente;
ariosamente===ariosamente;
cosà===cosà;
insocievolmente===insocievolmente;
ospitalmente===ospitalmente;
scientificamente===scientificamente;
esistenzialisticamente===esistenzialisticamente;
conseguentemente===conseguentemente;
elettronicamente===elettronicamente;
proceduralmente===proceduralmente;
asinescamente===asinescamente;
surrettiziamente===surrettiziamente;
logorroicamente===logorroicamente;
disopra===disopra;
accosto===accosto;
eristicamente===eristicamente;
estrinsecamente===estrinsecamente;
violabilmente===violabilmente;
geometricamente===geometricamente;
collateralmente===collateralmente;
spigolosamente===spigolosamente;
veramente===veramente;
perdurabilemente===perdurabilemente;
spiritualmente===spiritualmente;
uggiosamente===uggiosamente;
condizionalmente===condizionalmente;
informemente===informemente;
elettivamente===elettivamente;
signorsì===signorsì;
svariatamente===svariatamente;
dissolutamente===dissolutamente;
massivamente===massivamente;
perspicuamente===perspicuamente;
così===così;
criminalmente===criminalmente;
precipitevolissimevolmente===precipitevolissimevolmente;
nominativamente===nominativamente;
agilmente===agilmente;
illogicamente===illogicamente;
birbantescamente===birbantescamente;
proprio===proprio;
fissamente===fissamente;
mansuetamente===mansuetamente;
posteriormente===posteriormente;
endemicamente===endemicamente;
escatologicamente===escatologicamente;
viceversa===viceversa;
fondatamente===fondatamente;
amaramente===amaramente;
interattivamente===interattivamente;
indifferenziamente===indifferenziamente;
onomatopeicamente===onomatopeicamente;
monopolisticamente===monopolisticamente;
cosmicamente===cosmicamente;
insanamente===insanamente;
succintamente===succintamente;
inapprensibilmente===inapprensibilmente;
fiduciosamente===fiduciosamente;
razionalisticamente===razionalisticamente;
intuibilmente===intuibilmente;
eccentricamente===eccentricamente;
incontrollabilmente===incontrollabilmente;
volenterosamente===volenterosamente;
tentoni===tentoni;
barbaramente===barbaramente;
scetticamente===scetticamente;
mendacemente===mendacemente;
operosamente===operosamente;
ebraicamente===ebraicamente;
impoliticamente===impoliticamente;
inesprimibilmente===inesprimibilmente;
pregiudizialmente===pregiudizialmente;
incessantemente===incessantemente;
machiavellicamente===machiavellicamente;
flessuosamente===flessuosamente;
dopodiché===dopodiché;dopodichè;
ordinatamente===ordinatamente;
meditativamente===meditativamente;
legittimamente===legittimamente;
imprecisabilmente===imprecisabilmente;
orribilmente===orribilmente;
etnicamente===etnicamente;
caratteristicamente===caratteristicamente;
cionondimeno===cionondimeno;
laboriosamente===laboriosamente;
collericamente===collericamente;
maschilmente===maschilmente;
signornò===signornò;
dogmaticamente===dogmaticamente;
epistolarmente===epistolarmente;
dispettosamente===dispettosamente;
collettivamente===collettivamente;
leggiadramente===leggiadramente;
estraneamente===estraneamente;
unicamente===unicamente;
fascinosamente===fascinosamente;
confortevolmente===confortevolmente;
impeditamente===impeditamente;
razionalmente===razionalmente;
farmaceuticamente===farmaceuticamente;
fraternamente===fraternamente;
raucamente===raucamente;
poeticamente===poeticamente;
altresì===altresì;
antiteticamente===antiteticamente;
profondo===profondo;
venerabilmente===venerabilmente;
strettamente===strettamente;
bilanciatamente===bilanciatamente;
epidemiologicamente===epidemiologicamente;
rovinosamente===rovinosamente;
idrograficamente===idrograficamente;
eugeneticamente===eugeneticamente;
smaccatamente===smaccatamente;
ladramente===ladramente;
inconsciamente===inconsciamente;
miseramente===miseramente;
geneticamente===geneticamente;
fecondamente===fecondamente;
dottrinalmente===dottrinalmente;
parabolicamente===parabolicamente;
processualmente===processualmente;
legnosamente===legnosamente;
quaggiù===quaggiù;
immotivatamente===immotivatamente;
abioticamente===abioticamente;
equabilmente===equabilmente;
dispregiativamente===dispregiativamente;
virtualmente===virtualmente;
esageratamente===esageratamente;
impermeabilmente===impermeabilmente;
sardonicamente===sardonicamente;
nominatamente===nominatamente;
decorosamente===decorosamente;
pirandellianamente===pirandellianamente;
poppavia===poppavia;
lassù===lassù;
prossimamente===prossimamente;
riferibilmente===riferibilmente;
grettamente===grettamente;
all'incontrario===all'incontrario;
ecletticamente===ecletticamente;
stamattina===stamattina;
persino===persino;
gaudiosamente===gaudiosamente;
dissennatamente===dissennatamente;
inquietamente===inquietamente;
lecitamente===lecitamente;
medicinalmente===medicinalmente;
peculiarmente===peculiarmente;
nottetempo===nottetempo;
perlopiù===perlopiù;
anticamente===anticamente;
oltre===oltre;
decisivamente===decisivamente;
illibatamente===illibatamente;
silenziosamente===silenziosamente;
spensieratamente===spensieratamente;
conformisticamente===conformisticamente;
sottilmente===sottilmente;
invincibilmente===invincibilmente;
scomodamente===scomodamente;
concordemente===concordemente;
segretamente===segretamente;
nemmeno===nemmeno;
birichinamente===birichinamente;
disagiatamente===disagiatamente;
legalmente===legalmente;
addosso===addosso;
strumentalmente===strumentalmente;
furtivamente===furtivamente;
inviolabilmente===inviolabilmente;
elettoralmente===elettoralmente;
indimostrabilmente===indimostrabilmente;
impellentemente===impellentemente;
presumibilmente===presumibilmente;
inappellabilmente===inappellabilmente;
perbene===perbene;
figuratamente===figuratamente;
equilibratamente===equilibratamente;
fiocamente===fiocamente;
verbosamente===verbosamente;
plausibilmente===plausibilmente;
irragionevolmente===irragionevolmente;
sospirosamente===sospirosamente;
puerilmente===puerilmente;
quale===quale;
abbasso===abbasso;
netto===netto;
francamente===francamente;
dopodomani===dopodomani;
armoniosamente===armoniosamente;
cristianamente===cristianamente;
laudativamente===laudativamente;
golosamente===golosamente;
irriferibilmente===irriferibilmente;
attentamente===attentamente;
puramente===puramente;
annalisticamente===annalisticamente;
sfrontatamente===sfrontatamente;
stolidamente===stolidamente;
inusitatamente===inusitatamente;
puntualmente===puntualmente;
cervelloticamente===cervelloticamente;
insindacabilmente===insindacabilmente;
ieraticamente===ieraticamente;
mentitamente===mentitamente;
perfino===perfino;
indefinitivamente===indefinitivamente;
pornograficamente===pornograficamente;
sottovento===sottovento;
processionalmente===processionalmente;
coscienziosamente===coscienziosamente;
perigliosamente===perigliosamente;
farsescamente===farsescamente;
lussuriosamente===lussuriosamente;
percettivamente===percettivamente;
enciclopedicamente===enciclopedicamente;
chiaro===chiaro;
facinorosamente===facinorosamente;
loquacemente===loquacemente;
ulteriormente===ulteriormente;
indegnamente===indegnamente;
fototelegraficamente===fototelegraficamente;
naturalmente===naturalmente;
torbidamente===torbidamente;
turpemente===turpemente;
stasera===stasera;
anche===anche;anch';
baldanzosamente===baldanzosamente;
intanto===intanto;
profusamente===profusamente;
circolarmente===circolarmente;
perbenisticamente===perbenisticamente;
inesauribilmente===inesauribilmente;
esorbitantemente===esorbitantemente;
calcolatamente===calcolatamente;
ammodo===ammodo;
ritualmente===ritualmente;
parsimoniosamente===parsimoniosamente;
insignificantemente===insignificantemente;
normalmente===normalmente;
infrangibilmente===infrangibilmente;
osservabilmente===osservabilmente;
autonomamente===autonomamente;
imprescindibilmente===imprescindibilmente;
chimicamente===chimicamente;
cerimonialmente===cerimonialmente;
demenzialmente===demenzialmente;
incoercibilmente===incoercibilmente;
episodicamente===episodicamente;
cronometricamente===cronometricamente;
mirabilmente===mirabilmente;
pluralisticamente===pluralisticamente;
intangibilmente===intangibilmente;
morganaticamente===morganaticamente;
calamitosamente===calamitosamente;
meticolosamente===meticolosamente;
fracassosamente===fracassosamente;
prudentemente===prudentemente;
oltreconfine===oltreconfine;
anticostituzionalmente===anticostituzionalmente;
disinteressatamente===disinteressatamente;
sagacemente===sagacemente;
angosciosamente===angosciosamente;
inestricabilmente===inestricabilmente;
paradigmaticamente===paradigmaticamente;
concentricamente===concentricamente;
malinconicamente===malinconicamente;
beneficamente===beneficamente;
nemicamente===nemicamente;
letteralmente===letteralmente;
sdegnosamente===sdegnosamente;
retrospettivamente===retrospettivamente;
indipendentemente===indipendentemente;
infinitamente===infinitamente;
invano===invano;
significativamente===significativamente;
indiscernibilmente===indiscernibilmente;
indarno===indarno;
altamente===altamente;
colorimetricamente===colorimetricamente;
seriosamente===seriosamente;
benevolentemente===benevolentemente;
focosamente===focosamente;
incestuosamente===incestuosamente;
premurosamente===premurosamente;
secondariamente===secondariamente;
spiacevolmente===spiacevolmente;
splendidamente===splendidamente;
arditamente===arditamente;
placidamente===placidamente;
tenuemente===tenuemente;
malagevolmente===malagevolmente;
orrendamente===orrendamente;
abbondevolmente===abbondevolmente;
lacunosamente===lacunosamente;
discordemente===discordemente;
quasi===quasi;
impertinentemente===impertinentemente;
sottolio===sottolio;
meritatamente===meritatamente;
tempestivamente===tempestivamente;
densamente===densamente;
maleducatamente===maleducatamente;
artificialmente===artificialmente;
ciberneticamente===ciberneticamente;
dodecafonicamente===dodecafonicamente;
cafonescamente===cafonescamente;
entusiasticamente===entusiasticamente;
semmai===semmai;
strepitosamente===strepitosamente;
agonisticamente===agonisticamente;
lucentemente===lucentemente;
parimenti===parimenti;
compiacentemente===compiacentemente;
biennalmente===biennalmente;
anticonformisticamente===anticonformisticamente;
sennò===sennò;
laicamente===laicamente;
precedentemente===precedentemente;
instancabilmente===instancabilmente;
strategicamente===strategicamente;
indietro===indietro;
ringhiosamente===ringhiosamente;
bibliograficamente===bibliograficamente;
pronominalmente===pronominalmente;
sissignora===sissignora;
munificamente===munificamente;
articolatamente===articolatamente;
inesplicabilmente===inesplicabilmente;
sissignore===sissignore;sissignor;
compendiosamente===compendiosamente;
stericamente===stericamente;
distaccatamente===distaccatamente;
astiosamente===astiosamente;
indentro===indentro;
orridamente===orridamente;
universalmente===universalmente;
grandiosamente===grandiosamente;
paganamente===paganamente;
slealmente===slealmente;
commercialmente===commercialmente;
successivamente===successivamente;
scusabilmente===scusabilmente;
ministerialmente===ministerialmente;
involontariamente===involontariamente;
cinematograficamente===cinematograficamente;
fotograficamente===fotograficamente;
cospicuamente===cospicuamente;
nebulosamente===nebulosamente;
telematicamente===telematicamente;
frammezzo===frammezzo;
distalmente===distalmente;
irripetibilmente===irripetibilmente;
opportunisticamente===opportunisticamente;
fuori===fuori;fuor;
impudentemente===impudentemente;
incisivamente===incisivamente;
foltamente===foltamente;
lontanamente===lontanamente;
incontestabilmente===incontestabilmente;
araldicamente===araldicamente;
vivamente===vivamente;
meravigliosamente===meravigliosamente;
specificamente===specificamente;
cortigianescamente===cortigianescamente;
divisibilmente===divisibilmente;
computazionalmente===computazionalmente;
inopportunamente===inopportunamente;
cocciutamente===cocciutamente;
fiorentemente===fiorentemente;
mortiferamente===mortiferamente;
italicamente===italicamente;
perniciosamente===perniciosamente;
brutalmente===brutalmente;
anguillescamente===anguillescamente;
ariosità===ariosità;
intercambiabilmente===intercambiabilmente;
indiscutibilmente===indiscutibilmente;
apoliticamente===apoliticamente;
subitaneamente===subitaneamente;
alcolicamente===alcolicamente;
incondizionatamente===incondizionatamente;
invero===invero;
territorialmente===territorialmente;
inestinguibilmente===inestinguibilmente;
enigmaticamente===enigmaticamente;
attillatamente===attillatamente;
altezzosamente===altezzosamente;
ineducatamente===ineducatamente;
acquiescentemente===acquiescentemente;
medialmente===medialmente;
motivatamente===motivatamente;
ereditariamente===ereditariamente;
analogamente===analogamente;
avventurosamente===avventurosamente;
instabilmente===instabilmente;
illustremente===illustremente;
prosperamente===prosperamente;
pro-capite===pro-capite;
eccellentemente===eccellentemente;
profilatticamente===profilatticamente;
zelantemente===zelantemente;
perfidamente===perfidamente;
ineguagliabilmente===ineguagliabilmente;
paciosamente===paciosamente;
molteplicemente===molteplicemente;
statutariamente===statutariamente;
esponenzialmente===esponenzialmente;
inerentemente===inerentemente;
inconsolabilmente===inconsolabilmente;
indispensabilmente===indispensabilmente;
stesso===stesso;
oltremare===oltremare;
accademicamente===accademicamente;
angelicamente===angelicamente;
spigliatamente===spigliatamente;
convenientemente===convenientemente;
nettamente===nettamente;
rispettosamente===rispettosamente;
impuramente===impuramente;
formalmente===formalmente;
arcaicamente===arcaicamente;
appieno===appieno;
loscamente===loscamente;
foscamente===foscamente;
rabbinicamente===rabbinicamente;
provincialmente===provincialmente;
rispettivamente===rispettivamente;
incontenibilmente===incontenibilmente;
incontrario===incontrario;
inoperosamente===inoperosamente;
sovranamente===sovranamente;
mediatamente===mediatamente;
brievemente===brievemente;
gastronomicamente===gastronomicamente;
buffonescamente===buffonescamente;
analiticamente===analiticamente;
ammirabilmente===ammirabilmente;
istericamente===istericamente;
cartesianamente===cartesianamente;
quadrupedia===quadrupedia;
sensualmente===sensualmente;
salutariamente===salutariamente;
infelicemente===infelicemente;
delittuosamente===delittuosamente;
irreversibilmente===irreversibilmente;
sordidamente===sordidamente;
dieteticamente===dieteticamente;
diplomaticamente===diplomaticamente;
massicciamente===massicciamente;
aspramente===aspramente;
retroattivamente===retroattivamente;
disciplinarmente===disciplinarmente;
imponentemente===imponentemente;
inconsideratamente===inconsideratamente;
scopertamente===scopertamente;
neanche===neanche;neanch;neanch';
dunque===dunque;
lievemente===lievemente;
animalescamente===animalescamente;
colloquialmente===colloquialmente;
mitologicamente===mitologicamente;
spasmodicamente===spasmodicamente;
metodologicamente===metodologicamente;
duramente===duramente;
costrittivamente===costrittivamente;
fallacemente===fallacemente;
espositivamente===espositivamente;
imbarazzatamente===imbarazzatamente;
beffardamente===beffardamente;
rabbiosamente===rabbiosamente;
ottimisticamente===ottimisticamente;
illecitamente===illecitamente;
indimenticabilmente===indimenticabilmente;
endovena===endovena;
algebricamente===algebricamente;
negozialmente===negozialmente;
comunicativamente===comunicativamente;
dubbiosamente===dubbiosamente;
inorganicamente===inorganicamente;
servilmente===servilmente;
baronescamente===baronescamente;
aboralmente===aboralmente;
consistentemente===consistentemente;
iniquamente===iniquamente;
spudoratamente===spudoratamente;
indissolubilmente===indissolubilmente;
gratis===gratis;
indifendibilmente===indifendibilmente;
armonicamente===armonicamente;
odiernamente===odiernamente;
modernamente===modernamente;
tempestosamente===tempestosamente;
curvamente===curvamente;
correlatamente===correlatamente;
partenogeneticamente===partenogeneticamente;
onorevolmente===onorevolmente;
concretamente===concretamente;
mercenariamente===mercenariamente;
antipaticamente===antipaticamente;
curialmente===curialmente;
radiosamente===radiosamente;
illimitatamente===illimitatamente;
melodrammaticamente===melodrammaticamente;
feudalmente===feudalmente;
detestabilmente===detestabilmente;
tumultuosamente===tumultuosamente;
umilmente===umilmente;
correntemente===correntemente;
duplicatamente===duplicatamente;
contiguamente===contiguamente;
estivamente===estivamente;
considerabilmente===considerabilmente;
magnificentemente===magnificentemente;
etnologicamente===etnologicamente;
labilmente===labilmente;
altrimenti===altrimenti;
funereamente===funereamente;
lamentabilmente===lamentabilmente;
ginecologicamente===ginecologicamente;
coraggiosamente===coraggiosamente;
satiricamente===satiricamente;
assiomaticamente===assiomaticamente;
domattina===domattina;
deferentemente===deferentemente;
diametralmente===diametralmente;
diligentemente===diligentemente;
dopotutto===dopotutto;
improbabilmente===improbabilmente;
burbanzosamente===burbanzosamente;
lisciamente===lisciamente;
spessissimo===spessissimo;
derisoriamente===derisoriamente;
inappuntabilmente===inappuntabilmente;
dovecchessia===dovecchessia;
sconvenientemente===sconvenientemente;
subordinatamente===subordinatamente;
dimessamente===dimessamente;
unitariamente===unitariamente;
unitamente===unitamente;
acriticamente===acriticamente;
contrariamente===contrariamente;
informalmente===informalmente;
irreprensibilmente===irreprensibilmente;
infatti===infatti;
meteorologicamente===meteorologicamente;
sconnessamente===sconnessamente;
definitivamente===definitivamente;
macchinosamente===macchinosamente;
mordacemente===mordacemente;
serenamente===serenamente;
impalpabilmente===impalpabilmente;
dubitativamente===dubitativamente;
sbiecamente===sbiecamente;
intempestivamente===intempestivamente;
maestrevolmente===maestrevolmente;
inenarrabilmente===inenarrabilmente;
aerobicamente===aerobicamente;
monarchicamente===monarchicamente;
arrischiatamente===arrischiatamente;
inclusivamente===inclusivamente;
pionieristicamente===pionieristicamente;
già===già;
modicamente===modicamente;
ineluttabilmente===ineluttabilmente;
adagio===adagio;
mafiosamente===mafiosamente;
metaforicamente===metaforicamente;
eccola===eccola;
mollemente===mollemente;
poi===poi;
sotterra===sotterra;
irresistibilmente===irresistibilmente;
donchisciottescamente===donchisciottescamente;
aulicamente===aulicamente;
innanzi===innanzi;
dolentemente===dolentemente;
emozionatamente===emozionatamente;
idealmente===idealmente;
costituzionalmente===costituzionalmente;
autoritativamente===autoritativamente;
ripetutamente===ripetutamente;
inconsistentemente===inconsistentemente;
lucidamente===lucidamente;
scherzosamente===scherzosamente;
didietro===didietro;
correttamente===correttamente;
glissando===glissando;
eufemisticamente===eufemisticamente;
topograficamente===topograficamente;
fastidiosamente===fastidiosamente;
lapidariamente===lapidariamente;
assonnatamente===assonnatamente;
peggio===peggio;
neurologicamente===neurologicamente;
faunisticamente===faunisticamente;
nocivamente===nocivamente;
innumerevolmente===innumerevolmente;
procacemente===procacemente;
scortesemente===scortesemente;
invece===invece;
materialisticamente===materialisticamente;
rigogliosamente===rigogliosamente;
relativamente===relativamente;
oltrefrontiera===oltrefrontiera;
manescamente===manescamente;
alfine===alfine;
giù===giù;
fottutamente===fottutamente;
graficamente===graficamente;
sufficientemente===sufficientemente;
rovescioni===rovescioni;
sottobordo===sottobordo;
ingiù===ingiù;
raffinatamente===raffinatamente;
ingiustificabilmente===ingiustificabilmente;
poderosamente===poderosamente;
bene===bene;ben;
telefonicamente===telefonicamente;
studiatamente===studiatamente;
termicamente===termicamente;
partigianamente===partigianamente;
clandestinamente===clandestinamente;
elettrochimicamente===elettrochimicamente;
audacemente===audacemente;
medicalmente===medicalmente;
celermente===celermente;
vividamente===vividamente;
brevemente===brevemente;
infingardamente===infingardamente;
impassibilmente===impassibilmente;
bastevolmente===bastevolmente;
narcisisticamente===narcisisticamente;
smorfiosamente===smorfiosamente;
mutualisticamente===mutualisticamente;
felicemente===felicemente;
moderatamente===moderatamente;
bocconi===bocconi;
equivalentemente===equivalentemente;
orgiasticamente===orgiasticamente;
eternamente===eternamente;
autobiograficamente===autobiograficamente;
difronte===difronte;
dove===dove;dov;dov';
religiosamente===religiosamente;
perdutamente===perdutamente;
ecclesiasticamente===ecclesiasticamente;
periodicamente===periodicamente;
esemplarmente===esemplarmente;
daccanto===daccanto;
atleticamente===atleticamente;
eccomi===eccomi;
eccome===eccome;
discernibilmente===discernibilmente;
lividamente===lividamente;
caninamente===caninamente;
timbricamente===timbricamente;
credibilmente===credibilmente;
perfezionisticamente===perfezionisticamente;
bellicosamente===bellicosamente;
sgradevolmente===sgradevolmente;
eccolo===eccolo;
fulgidamente===fulgidamente;
seriamente===seriamente;
eccoli===eccoli;
apoditticamente===apoditticamente;
eccole===eccole;
infedelmente===infedelmente;
difilato===difilato;
sistematicamente===sistematicamente;
istituzionalmente===istituzionalmente;
assurdamente===assurdamente;
farmacologicamente===farmacologicamente;
sostanziosamente===sostanziosamente;
asessuatamente===asessuatamente;
ostensivamente===ostensivamente;
aerodinamicamente===aerodinamicamente;
calorosamente===calorosamente;
impavidamente===impavidamente;
difilate===difilate;
empiricamente===empiricamente;
benemeritamente===benemeritamente;
eccoti===eccoti;
lamentosamente===lamentosamente;
sottomisura===sottomisura;
birbonescamente===birbonescamente;
diversamente===diversamente;
geograficamente===geograficamente;
discutibilmente===discutibilmente;
ratealmente===ratealmente;
pallidamente===pallidamente;
scrupolosamente===scrupolosamente;
indirettamente===indirettamente;
iugulatoriamente===iugulatoriamente;
sforzatamente===sforzatamente;
brachilogicamente===brachilogicamente;
ibridamente===ibridamente;
irreligiosamente===irreligiosamente;
innamoratamente===innamoratamente;
scolasticamente===scolasticamente;
combinatamente===combinatamente;
indomitamente===indomitamente;
malleabilmente===malleabilmente;
violentemente===violentemente;
dissipatamente===dissipatamente;
colpevolmente===colpevolmente;
atermicamente===atermicamente;
vanitosamente===vanitosamente;
longitudinalmente===longitudinalmente;
organicamente===organicamente;
leccatamente===leccatamente;
gravosamente===gravosamente;
inderogabilmente===inderogabilmente;
confucianamente===confucianamente;
lemme===lemme;
liberamente===liberamente;
fiaccamente===fiaccamente;
tipograficamente===tipograficamente;
certo===certo;
connaturatamente===connaturatamente;
indiavolatamente===indiavolatamente;
schematicamente===schematicamente;
classicisticamente===classicisticamente;
fraudolentemente===fraudolentemente;
parenteralmente===parenteralmente;
protervamente===protervamente;
faziosamente===faziosamente;
petulantemente===petulantemente;
svantaggiosamente===svantaggiosamente;
infruttuosamente===infruttuosamente;
indelebilmente===indelebilmente;
orientativamente===orientativamente;
indifferibilmente===indifferibilmente;
luridamente===luridamente;
ecologicamente===ecologicamente;
incommensurabilmente===incommensurabilmente;
semestralmente===semestralmente;
diagonalmente===diagonalmente;
impareggiabilmente===impareggiabilmente;
assestatamente===assestatamente;
incontestatamente===incontestatamente;
cripticamente===cripticamente;
ampollosamente===ampollosamente;
dantescamente===dantescamente;
aridamente===aridamente;
presto===presto;
pacchianamente===pacchianamente;
bramosamente===bramosamente;
medievalmente===medievalmente;
fertilemente===fertilemente;
idiotamente===idiotamente;
eccovi===eccovi;
scientemente===scientemente;
antiscientificamente===antiscientificamente;
saputamente===saputamente;
finanche===finanche;
completamente===completamente;compietamente;
presso===presso;
quietamente===quietamente;
spassionatamente===spassionatamente;
tautologicamente===tautologicamente;
paranoicamente===paranoicamente;
efferatamente===efferatamente;
perlomeno===perlomeno;
solitamente===solitamente;
sconvenevolmente===sconvenevolmente;
intenzionalmente===intenzionalmente;
congenitamente===congenitamente;
malgrado===malgrado;
caporovescio===caporovescio;
sapientemente===sapientemente;
perseverantemente===perseverantemente;
vogliosamente===vogliosamente;
extragiudizialmente===extragiudizialmente;estragiudizialmente;
accuratamente===accuratamente;
inconsultamente===inconsultamente;
pietisticamente===pietisticamente;
palesemente===palesemente;
ipnoticamente===ipnoticamente;
esosamente===esosamente;
apparentemente===apparentemente;
alacremente===alacremente;
incidentalmente===incidentalmente;
favolosamente===favolosamente;
fatidicamente===fatidicamente;
dissuasivamente===dissuasivamente;
appropriatamente===appropriatamente;
retoricamente===retoricamente;
sottocoperta===sottocoperta;
anticostituzionalissimamente===anticostituzionalissimamente;
dovunque===dovunque;
lungamente===lungamente;
inumanamente===inumanamente;
agevolmente===agevolmente;
cronologicamente===cronologicamente;
svenevolmente===svenevolmente;
meschinamente===meschinamente;
ardentemente===ardentemente;
pressapoco===pressapoco;
fuorigioco===fuorigioco;
accettabilmente===accettabilmente;
panteisticamente===panteisticamente;
originariamente===originariamente;
flemmaticamente===flemmaticamente;
anticipatamente===anticipatamente;
filosoficamente===filosoficamente;
incongruentemente===incongruentemente;
indecorosamente===indecorosamente;
modernisticamente===modernisticamente;
fa===fa;
annualmente===annualmente;
impunemente===impunemente;
paesaggisticamente===paesaggisticamente;
programmaticamente===programmaticamente;
assertivamente===assertivamente;
straccamente===straccamente;
elementarmente===elementarmente;
dialettalmente===dialettalmente;
ampiamente===ampiamente;
rapinosamente===rapinosamente;
alternativamente===alternativamente;
supremamente===supremamente;
sbadatamente===sbadatamente;
spiritosamente===spiritosamente;
principalmente===principalmente;
caloricamente===caloricamente;
offensivamente===offensivamente;
staticamente===staticamente;
imperscrutabilmente===imperscrutabilmente;
proibitivamente===proibitivamente;
pariteticamente===pariteticamente;
istrionicamente===istrionicamente;
controluce===controluce;
oltralpe===oltralpe;
incivilmente===incivilmente;
lontano===lontano;
figurativamente===figurativamente;
morbidamente===morbidamente;
pugilisticamente===pugilisticamente;
euritmicamente===euritmicamente;
imbrogliatamente===imbrogliatamente;
ana===ana;
immeritevolmente===immeritevolmente;
vivacemente===vivacemente;
dissimilmente===dissimilmente;
capitomboloni===capitomboloni;
ci===ci;
stupendamente===stupendamente;
protettivamente===protettivamente;
regolatamente===regolatamente;
lupescamente===lupescamente;
smisuratamente===smisuratamente;
malavventuratamente===malavventuratamente;
anormalmente===anormalmente;
preminentemente===preminentemente;
stereochimicamente===stereochimicamente;
comunque===comunque;
luminosamente===luminosamente;
tacitianamente===tacitianamente;
aleatoriamente===aleatoriamente;
metallicamente===metallicamente;
inavvertitamente===inavvertitamente;
tabeticamente===tabeticamente;
massimamente===massimamente;
dilettantisticamente===dilettantisticamente;
malignamente===malignamente;
politeisticamente===politeisticamente;
innumerabilmente===innumerabilmente;
separatamente===separatamente;
caudalmente===caudalmente;
saltelloni===saltelloni;
scioccamente===scioccamente;
prematuramente===prematuramente;
comicamente===comicamente;
convenevolmente===convenevolmente;
criminosamente===criminosamente;
maschilisticamente===maschilisticamente;
coniugalmente===coniugalmente;
doppiamente===doppiamente;
industriosamente===industriosamente;
dubitosamente===dubitosamente;
trasandatamente===trasandatamente;
no===no;
perdurabilmente===perdurabilmente;
concisamente===concisamente;
nn===nn;
introversamente===introversamente;
numerosamente===numerosamente;
framezzo===framezzo;
smodatamente===smodatamente;
possentemente===possentemente;
bugiardamente===bugiardamente;
impulsivamente===impulsivamente;
edonisticamente===edonisticamente;
celestialmente===celestialmente;
dappoi===dappoi;
incoscientemente===incoscientemente;
superlativamente===superlativamente;
sconciamente===sconciamente;
ponderosamente===ponderosamente;
immodestamente===immodestamente;
caparbiamente===caparbiamente;
sgraziatamente===sgraziatamente;
orgogliosamente===orgogliosamente;
granchè===granchè;
arbitrariamente===arbitrariamente;
granché===granché;
effettivamente===effettivamente;
strutturalmente===strutturalmente;
là===là;
gratuitamente===gratuitamente;
idraulicamente===idraulicamente;
frugalmente===frugalmente;
corporalmente===corporalmente;
intemperantemente===intemperantemente;
fumosamente===fumosamente;
donde===donde;
indistricabilmente===indistricabilmente;
retro===retro;
sediziosamente===sediziosamente;
educatamente===educatamente;
maggiormente===maggiormente;
impreteribilmente===impreteribilmente;
creativamente===creativamente;
infidamente===infidamente;
socraticamente===socraticamente;
magistralmente===magistralmente;
dappiè===dappiè;
subatomicamente===subatomicamente;
indefettibilmente===indefettibilmente;
sillogisticamente===sillogisticamente;
sregolatamente===sregolatamente;
cerimoniosamente===cerimoniosamente;
accoratamente===accoratamente;
nossignore===nossignore;
collegialmente===collegialmente;
mo===mo;
obbrobriosamente===obbrobriosamente;
energicamente===energicamente;
rusticamente===rusticamente;
inefficientemente===inefficientemente;
sudiciamente===sudiciamente;
dopo===dopo;
neppure===neppure;neppur;
affidabilmente===affidabilmente;
bimensilmente===bimensilmente;
continentemente===continentemente;
parzialmente===parzialmente;
appuntino===appuntino;
monotonamente===monotonamente;
ne===ne;
patrimonialmente===patrimonialmente;
ni===ni;
autisticamente===autisticamente;
eccoci===eccoci;
indifferenziatamente===indifferenziatamente;
nossignora===nossignora;
gracilmente===gracilmente;
forsennatamente===forsennatamente;
monotematicamente===monotematicamente;
tetramente===tetramente;
ferventemente===ferventemente;
pecuniariamente===pecuniariamente;
inammissibilmente===inammissibilmente;
conclusivamente===conclusivamente;
insopportabilmente===insopportabilmente;
irraggiungibilmente===irraggiungibilmente;
luttuosamente===luttuosamente;
razzialmente===razzialmente;
monoliticamente===monoliticamente;
collaborativamente===collaborativamente;
tirannicamente===tirannicamente;
cannibalescamente===cannibalescamente;
equidistantemente===equidistantemente;
appunto===appunto;
evangelicamente===evangelicamente;
sacrilegamente===sacrilegamente;
idem===idem;
palpabilmente===palpabilmente;
biliosamente===biliosamente;
soprappensiero===soprappensiero;
latentemente===latentemente;
larvatamente===larvatamente;
miserevolmente===miserevolmente;
metateticamente===metateticamente;
preordinatamente===preordinatamente;
internamente===internamente;
indebitamente===indebitamente;
urgentemente===urgentemente;
encomiabilmente===encomiabilmente;
rancorosamente===rancorosamente;
vivibilmente===vivibilmente;
esteticamente===esteticamente;
disgustosamente===disgustosamente;
infrequentemente===infrequentemente;
settimanalmente===settimanalmente;
epidemicamente===epidemicamente;
insondabilmente===insondabilmente;
condiscendentemente===condiscendentemente;
domani===domani;
contrappuntisticamente===contrappuntisticamente;
troppo===troppo;
puntalmente===puntalmente;
nient'affatto===nient'affatto;
burrascosamente===burrascosamente;
zoppiconi===zoppiconi;
gerarchicamente===gerarchicamente;
autolesionisticamente===autolesionisticamente;
cenciosamente===cenciosamente;
indescrivibilmente===indescrivibilmente;
frontalità===frontalità;
demograficamente===demograficamente;
angustiosamente===angustiosamente;
pittoricamente===pittoricamente;
infra===infra;
termodinamicamente===termodinamicamente;
piattamente===piattamente;
meglio===meglio;
notabilmente===notabilmente;
prodigiosamente===prodigiosamente;
integralmente===integralmente;
regolarmente===regolarmente;
bricconescamente===bricconescamente;
mostruosamente===mostruosamente;
sù===sù;
spettacolarmente===spettacolarmente;
monasticamente===monasticamente;
precipitevolmente===precipitevolmente;
blandamente===blandamente;
biasimevolmente===biasimevolmente;
durevolmente===durevolmente;
confusamente===confusamente;
inspiegabilmente===inspiegabilmente;
qualmente===qualmente;
eccetera===eccetera;
sì===sì;
disavvedutamente===disavvedutamente;
costantemente===costantemente;
pure===pure;pur;
incancellabilmente===incancellabilmente;
fisiologicamente===fisiologicamente;
magneticamente===magneticamente;
teocentricamente===teocentricamente;
manifestamente===manifestamente;
vi===vi;
sequenzialmente===sequenzialmente;
turbinosamente===turbinosamente;
cretinamente===cretinamente;
argutamente===argutamente;
dapprincipio===dapprincipio;
industrialmente===industrialmente;
invisibilmente===invisibilmente;
pulitamente===pulitamente;
furbescamente===furbescamente;
equivocamente===equivocamente;
qualche===qualche;
posatamente===posatamente;
malevolmente===malevolmente;
adesso===adesso;
alteratamente===alteratamente;
disorganicamente===disorganicamente;
ottimamente===ottimamente;
antipatriotticamente===antipatriotticamente;
gravemente===gravemente;
encomiasticamente===encomiasticamente;
coattivamente===coattivamente;
biologicamente===biologicamente;
dirimpetto===dirimpetto;
primariamente===primariamente;
nulla===nulla;
ardimentosamente===ardimentosamente;
chissà===chissà;
scenograficamente===scenograficamente;
illusoriamente===illusoriamente;
tapinamente===tapinamente;
sinceramente===sinceramente;
incomprensibilmente===incomprensibilmente;
miserabilmente===miserabilmente;
infrenabilmente===infrenabilmente;
acceleratamente===acceleratamente;
soddisfacentemente===soddisfacentemente;
stoltamente===stoltamente;
elaboratamente===elaboratamente;
su===su;
ambiguamente===ambiguamente;
fantasmagoricamente===fantasmagoricamente;
antropologicamente===antropologicamente;
deterministicamente===deterministicamente;
qua===qua;
contestualmente===contestualmente;
litograficamente===litograficamente;
incalcolabilmente===incalcolabilmente;
fattivamente===fattivamente;
panoramicamente===panoramicamente;
magnanimamente===magnanimamente;
permanentemente===permanentemente;
dopopranzo===dopopranzo;
carponi===carponi;carpon;
metabolicamente===metabolicamente;
ovviamente===ovviamente;
benevolmente===benevolmente;
infervoratamente===infervoratamente;
pidocchiosamente===pidocchiosamente;
illuminatamente===illuminatamente;
voluttuosamente===voluttuosamente;
pusillanimamente===pusillanimamente;
qui===qui;
infuori===infuori;
penetrantemente===penetrantemente;
iermattina===iermattina;
epistolograficamente===epistolograficamente;
dovutamente===dovutamente;
assieme===assieme;
balisticamente===balisticamente;
addominalmente===addominalmente;
neorealisticamente===neorealisticamente;
micragnosamente===micragnosamente;
capillarmente===capillarmente;
lì===lì;
attrattivamente===attrattivamente;
voluminosamente===voluminosamente;
stocasticamente===stocasticamente;
giuridicamente===giuridicamente;
atipicamente===atipicamente;
cito===cito;
riduttivamente===riduttivamente;
importunamente===importunamente;
propio===propio;
enarmonicamente===enarmonicamente;
affettuosamente===affettuosamente;
tangenzialmente===tangenzialmente;
disinvoltamente===disinvoltamente;
empiristicamente===empiristicamente;
ontologicamente===ontologicamente;
contendevolmente===contendevolmente;
risolutamente===risolutamente;
forse===forse;
perlaquale===perlaquale;
sottochiave===sottochiave;
capitalisticamente===capitalisticamente;
virtuosamente===virtuosamente;
crepapelle===crepapelle;
insofferentemente===insofferentemente;
inequivocabilmente===inequivocabilmente;
indistinguibilmente===indistinguibilmente;
inferiormente===inferiormente;
spazialmente===spazialmente;
consuetudinariamente===consuetudinariamente;
quà===quà;
fulmineamente===fulmineamente;
difficoltosamente===difficoltosamente;
spontaneamente===spontaneamente;
quì===quì;
pazientemente===pazientemente;
curiosamente===curiosamente;
disamoratamente===disamoratamente;
particolaristicamente===particolaristicamente;
incolmabilmente===incolmabilmente;
proporzionatamente===proporzionatamente;
razzisticamente===razzisticamente;
mutualmente===mutualmente;
somaticamente===somaticamente;
cioè===cioè;
banalmente===banalmente;
transitivamente===transitivamente;
bisbeticamente===bisbeticamente;
drammaticamente===drammaticamente;
nozionisticamente===nozionisticamente;
tardissimo===tardissimo;
indefinitamente===indefinitamente;
intraducibilmente===intraducibilmente;
complementarmente===complementarmente;
immediatamente===immediatamente;
orripilantemente===orripilantemente;
fermamente===fermamente;
ricorsivamente===ricorsivamente;
ortogonalmente===ortogonalmente;
protocollarmente===protocollarmente;
differenziatamente===differenziatamente;
oggi===oggi;
racemicamente===racemicamente;
indilazionabilmente===indilazionabilmente;
genuinamente===genuinamente;
meccanicisticamente===meccanicisticamente;
giocondamente===giocondamente;
deformemente===deformemente;
autodidatticamente===autodidatticamente;
inadeguatamente===inadeguatamente;
specialmente===specialmente;
additivamente===additivamente;
contegnosamente===contegnosamente;
deplorevolmente===deplorevolmente;
discosto===discosto;
puzzolentemente===puzzolentemente;
inquisitoriamente===inquisitoriamente;
perifericamente===perifericamente;
culturalmente===culturalmente;
vertiginosamente===vertiginosamente;
artificiosamente===artificiosamente;
invariabilmente===invariabilmente;
metalinguisticamente===metalinguisticamente;
smoderatamente===smoderatamente;
costà===costà;
onerosamente===onerosamente;
demagogicamente===demagogicamente;
intramontabilmente===intramontabilmente;
mortalmente===mortalmente;
intentamente===intentamente;
individualisticamente===individualisticamente;
nebbiosamente===nebbiosamente;
ingratamente===ingratamente;
spropositatamente===spropositatamente;
ciononostante===ciononostante;
d'avanzo===d'avanzo;
insperabilmente===insperabilmente;
mascolinamente===mascolinamente;
corposamente===corposamente;
tenacemente===tenacemente;
tangibilmente===tangibilmente;
inefficacemente===inefficacemente;
inestimabilmente===inestimabilmente;
assiduamente===assiduamente;
soggettivamente===soggettivamente;
cinicamente===cinicamente;
limitatamente===limitatamente;
volentieri===volentieri;
innatamente===innatamente;
tiepidamente===tiepidamente;
reciprocamente===reciprocamente;
irruentemente===irruentemente;
insino===insino;
rettamente===rettamente;
tendenziosamente===tendenziosamente;
atmosfericamente===atmosfericamente;
implicitamente===implicitamente;
equanimemente===equanimemente;
intersettorialmente===intersettorialmente;
adorabilmente===adorabilmente;
pressappoco===pressappoco;
ispiratamente===ispiratamente;
superbamente===superbamente;
signorilmente===signorilmente;
spietatamente===spietatamente;
accordabilmente===accordabilmente;
ingenerosamente===ingenerosamente;
tetraedricamente===tetraedricamente;
apposta===apposta;
sensibilmente===sensibilmente;
apologisticamente===apologisticamente;
antidemocraticamente===antidemocraticamente;
bizzarramente===bizzarramente;
attorno===attorno;
dichiarativamente===dichiarativamente;
saldamente===saldamente;
disagevolmente===disagevolmente;
feticisticamente===feticisticamente;
sparpagliatamente===sparpagliatamente;
fortunatamente===fortunatamente;
abiogeneticamente===abiogeneticamente;
repentinamente===repentinamente;
anacronisticamente===anacronisticamente;
burlescamente===burlescamente;
pertinentemente===pertinentemente;
preferibilmente===preferibilmente;
didatticamente===didatticamente;
insospettabilmente===insospettabilmente;
fintantoché===fintantoché;
primordialmente===primordialmente;
nuclearmente===nuclearmente;
deprecativamente===deprecativamente;
terapeuticamente===terapeuticamente;
abitualmente===abitualmente;
immacolatamente===immacolatamente;
dimostrativamente===dimostrativamente;
costosamente===costosamente;
artatamente===artatamente;
improcrastinabilmente===improcrastinabilmente;
enzimaticamente===enzimaticamente;
lacrimosamente===lacrimosamente;lagrimosamente;
magnificamente===magnificamente;
interminabilmente===interminabilmente;
efficientemente===efficientemente;
leggibilmente===leggibilmente;
litigiosamente===litigiosamente;
principescamente===principescamente;
profanamente===profanamente;
accomodabilmente===accomodabilmente;
eloquentemente===eloquentemente;
autorevolmente===autorevolmente;
peggiorativamente===peggiorativamente;
sprezzantemente===sprezzantemente;
acidamente===acidamente;
ammirevolmente===ammirevolmente;
vacillantemente===vacillantemente;
fotosinteticamente===fotosinteticamente;
ludicamente===ludicamente;
benino===benino;
remissibilmente===remissibilmente;
contrattualmente===contrattualmente;
fotometricamente===fotometricamente;
lamentevolmente===lamentevolmente;
antonomasticamente===antonomasticamente;
impropriamente===impropriamente;
angosciatamente===angosciatamente;
probamente===probamente;
flaccidamente===flaccidamente;
esclusivisticamente===esclusivisticamente;
batteriologicamente===batteriologicamente;
pensosamente===pensosamente;
provocatoriamente===provocatoriamente;
solennemente===solennemente;
misteriosamente===misteriosamente;
spocchiosamente===spocchiosamente;
burberamente===burberamente;
teatralmente===teatralmente;
laconicamente===laconicamente;
leggendariamente===leggendariamente;
praticamente===praticamente;
benintenzionatamente===benintenzionatamente;
compitamente===compitamente;
pressantemente===pressantemente;
insolubilmente===insolubilmente;
oltraggiosamente===oltraggiosamente;
sfarzosamente===sfarzosamente;
liberalmente===liberalmente;
perbenino===perbenino;
sboccatamente===sboccatamente;
dispersivamente===dispersivamente;
malamente===malamente;
vorticosamente===vorticosamente;
fervorosamente===fervorosamente;
amichevolmente===amichevolmente;
poscia===poscia;
cautelativamente===cautelativamente;
insufficientemente===insufficientemente;
eventualmente===eventualmente;
psicoanaliticamente===psicoanaliticamente;
didentro===didentro;
ufficialmente===ufficialmente;
imperialisticamente===imperialisticamente;
cagnescamente===cagnescamente;
opulentamente===opulentamente;opulentemente;
fortunosamente===fortunosamente;
dipendentemente===dipendentemente;
interrogativamente===interrogativamente;
insù===insù;
puritanamente===puritanamente;
dispoticamente===dispoticamente;
musicalmente===musicalmente;
danarosamente===danarosamente;
municipalmente===municipalmente;
rischiosamente===rischiosamente;
apartiticamente===apartiticamente;
compassionevolmente===compassionevolmente;
direttamente===direttamente;
ablativamente===ablativamente;
appiè===appiè;
disugualmente===disugualmente;
ultimamente===ultimamente;
inopinabilmente===inopinabilmente;
perfettamente===perfettamente;
bucolicamente===bucolicamente;
indeclinabilmente===indeclinabilmente;
maldestramente===maldestramente;
scipitamente===scipitamente;
uniformemente===uniformemente;
debolissimamente===debolissimamente;
rieccoci===rieccoci;
controvoglia===controvoglia;
minaccevolmente===minaccevolmente;
antigiuridicamente===antigiuridicamente;
onorevolemente===onorevolemente;
calcograficamente===calcograficamente;
irrefutabilmente===irrefutabilmente;
insormontabilmente===insormontabilmente;
idoneamente===idoneamente;
simultaneamente===simultaneamente;
canzonatoriamente===canzonatoriamente;
istruttivamente===istruttivamente;
ordinalmente===ordinalmente;
degnamente===degnamente;
automaticamente===automaticamente;
consuetamente===consuetamente;
intimamente===intimamente;
fortemente===fortemente;
pervicacemente===pervicacemente;
anzichenò===anzichenò;
complessivamente===complessivamente;
consorzialmente===consorzialmente;
furbamente===furbamente;
artigianalmente===artigianalmente;
buffamente===buffamente;
balordamente===balordamente;
affannosamente===affannosamente;
umanamente===umanamente;
sossopra===sossopra;
luculentemente===luculentemente;
imperialmente===imperialmente;
ieri===ieri;
fellonescamente===fellonescamente;
coordinatamente===coordinatamente;
asciuttamente===asciuttamente;
suppergiù===suppergiù;
viziatamente===viziatamente;
perspicacemente===perspicacemente;
insensatamente===insensatamente;
avvolgentemente===avvolgentemente;
criticamente===criticamente;
abbastanza===abbastanza;
sordamente===sordamente;
quassù===quassù;
ostensibilmente===ostensibilmente;
oscenamente===oscenamente;
cronicamente===cronicamente;
lagnosamente===lagnosamente;
ognora===ognora;ognor;
prepotentemente===prepotentemente;
similmente===similmente;
atrocemente===atrocemente;
nefastamente===nefastamente;
contraddittoriamente===contraddittoriamente;
copiosamente===copiosamente;
ritrosamente===ritrosamente;
trepidamente===trepidamente;
soprannumero===soprannumero;
mondialmente===mondialmente;
oltremanica===oltremanica;
plebiscitariamente===plebiscitariamente;
coerentemente===coerentemente;
svogliatamente===svogliatamente;
climaticamente===climaticamente;
miticamente===miticamente;
percettibilmente===percettibilmente;
peraltro===peraltro;
impeccabilmente===impeccabilmente;
sinusoidalmente===sinusoidalmente;
autoritariamente===autoritariamente;
apostolicamente===apostolicamente;
espertamente===espertamente;
tutto===tutto;
sottoterra===sottoterra;
conformemente===conformemente;
immortalmente===immortalmente;
difformemente===difformemente;
andantemente===andantemente;
sottopelle===sottopelle;
matematicamente===matematicamente;
neutralmente===neutralmente;
amorosamente===amorosamente;
inconseguentemente===inconseguentemente;
allora===allora;allor;
meridionalmente===meridionalmente;
anemicamente===anemicamente;
marcatamente===marcatamente;
masochisticamente===masochisticamente;
prosodicamente===prosodicamente;
compulsivamente===compulsivamente;
presocché===presocché;
sopravento===sopravento;
inverosimilmente===inverosimilmente;
dinanzi===dinanzi;
appiombo===appiombo;
prestamente===prestamente;
nepotisticamente===nepotisticamente;
evolutivamente===evolutivamente;
pudicamente===pudicamente;
raramente===raramente;
baldamente===baldamente;
confondibilmente===confondibilmente;
gagliardamente===gagliardamente;
esuberantemente===esuberantemente;
digitalmente===digitalmente;
intonatamente===intonatamente;
pleonasticamente===pleonasticamente;
morfologicamente===morfologicamente;
matronalmente===matronalmente;
aritmicamente===aritmicamente;
generosamente===generosamente;
allusivamente===allusivamente;
concettosamente===concettosamente;
avanti===avanti;avante;
candidamente===candidamente;
trionfalmente===trionfalmente;
euforicamente===euforicamente;
filatelicamente===filatelicamente;
macrobioticamente===macrobioticamente;
parassitariamente===parassitariamente;
incautamente===incautamente;
indiscretamente===indiscretamente;
accentuatamente===accentuatamente;
rasoterra===rasoterra;
sintatticamente===sintatticamente;
estensivamente===estensivamente;
sciaguratamente===sciaguratamente;
magari===magari;
attivamente===attivamente;
cremosamente===cremosamente;
corporeamente===corporeamente;
desolatamente===desolatamente;
individualmente===individualmente;
consapevolmente===consapevolmente;
malavvedutamente===malavvedutamente;
otticamente===otticamente;
disotto===disotto;
anagrammaticamente===anagrammaticamente;
vergognosamente===vergognosamente;
ormai===ormai;
parossisticamente===parossisticamente;
imponderabilmente===imponderabilmente;
livorosamente===livorosamente;
fragorosamente===fragorosamente;
interrottamente===interrottamente;
trascurabilmente===trascurabilmente;
ciascuno===ciascuno;ciascheduno;ciascuna;
saporosamente===saporosamente;
forzatamente===forzatamente;
esplosivamente===esplosivamente;
recentemente===recentemente;
scioperatamente===scioperatamente;
astrattamente===astrattamente;
ruvidamente===ruvidamente;
arrabbiatamente===arrabbiatamente;
incontrastabilmente===incontrastabilmente;
sottobanco===sottobanco;
correlativamente===correlativamente;
particolareggiatamente===particolareggiatamente;
inscindibilmente===inscindibilmente;
sostenibilmente===sostenibilmente;
santamente===santamente;
induttivamente===induttivamente;
comodamente===comodamente;
gradativamente===gradativamente;
nisba===nisba;
meritevolmente===meritevolmente;
torpidamente===torpidamente;
irriproducibilmente===irriproducibilmente;
prevedibilmente===prevedibilmente;
ciecamente===ciecamente;
flosciamente===flosciamente;
insolitamente===insolitamente;
materialmente===materialmente;
equipollentemente===equipollentemente;
numericamente===numericamente;
non===non;
apprensivamente===apprensivamente;
comprensivamente===comprensivamente;
memoria===memoria;
famelicamente===famelicamente;
affezionatamente===affezionatamente;
esiguamente===esiguamente;
indocilmente===indocilmente;
sottocosto===sottocosto;
abitudinariamente===abitudinariamente;
sottogamba===sottogamba;
caramente===caramente;
desiderosamente===desiderosamente;
male===male;
quindi===quindi;
semplicemente===semplicemente;
interessatamente===interessatamente;
perché===perché;
perchè===perchè;
monacalmente===monacalmente;
provvidenzialmente===provvidenzialmente;
spavaldamente===spavaldamente;
sconsideratamente===sconsideratamente;
lucullianamente===lucullianamente;
illeggibilmente===illeggibilmente;
immunologicamente===immunologicamente;
mimeticamente===mimeticamente;
indiziariamente===indiziariamente;
microbiologicamente===microbiologicamente;
quinci===quinci;
preistoricamente===preistoricamente;
fitto===fitto;
oppressivamente===oppressivamente;
solidamente===solidamente;
patentemente===patentemente;
disdicevolmente===disdicevolmente;
progressivamente===progressivamente;
irascibilmente===irascibilmente;
intellettualisticamente===intellettualisticamente;
differentemente===differentemente;
obbligatoriamente===obbligatoriamente;
inarrestabilmente===inarrestabilmente;
civicamente===civicamente;
sott'occhio===sott'occhio;
pedantemente===pedantemente;
medesimamente===medesimamente;
sinistramente===sinistramente;
lapalissianamente===lapalissianamente;
contortamente===contortamente;
oggigiorno===oggigiorno;
fisionomicamente===fisionomicamente;
forzosamente===forzosamente;
speditamente===speditamente;
notoriamente===notoriamente;
presuntuosamente===presuntuosamente;
passabilmente===passabilmente;
gutturalmente===gutturalmente;
insostituibilmente===insostituibilmente;
eminentemente===eminentemente;
inutilmente===inutilmente;
severamente===severamente;
annosamente===annosamente;
rapacemente===rapacemente;
incontro===incontro;incontr;
farraginosamente===farraginosamente;
eziando===eziando;
sottocute===sottocute;
anaerobicamente===anaerobicamente;
fiso===fiso;
nasalmente===nasalmente;
mediocremente===mediocremente;
impacciatamente===impacciatamente;
onde===onde;
salutarmente===salutarmente;
costantamente===costantamente;
gelosamente===gelosamente;
maturamente===maturamente;
lodabilmente===lodabilmente;
posdomani===posdomani;
sottovuoto===sottovuoto;
topologicamente===topologicamente;
pessimisticamente===pessimisticamente;
congetturalmente===congetturalmente;
persuasivamente===persuasivamente;
sovente===sovente;
stringatamente===stringatamente;
interdisciplinarmente===interdisciplinarmente;
sportivamente===sportivamente;
inversamente===inversamente;
irrilevantemente===irrilevantemente;
spesso===spesso;
sottovoce===sottovoce;
favorevolmente===favorevolmente;
azzardatamente===azzardatamente;
filologicamente===filologicamente;
soprattutto===soprattutto;
volontariamente===volontariamente;
immobilmente===immobilmente;
bastantemente===bastantemente;
studiosamente===studiosamente;
lessicalmente===lessicalmente;
sollecitamente===sollecitamente;
precocemente===precocemente;
licenziosamente===licenziosamente;
pavidamente===pavidamente;
giudiziosamente===giudiziosamente;
squisitamente===squisitamente;
asseritamente===asseritamente;
acremente===acremente;
inoltre===inoltre;
doppio===doppio;
fatalmente===fatalmente;
avvedutamente===avvedutamente;
sincronizzatamente===sincronizzatamente;
munificentemente===munificentemente;
onoratamente===onoratamente;
longanimemente===longanimemente;
ingenuamente===ingenuamente;
etologicamente===etologicamente;
caritatevolmente===caritatevolmente;
opacamente===opacamente;
dondoloni===dondoloni;
manualmente===manualmente;
superstiziosamente===superstiziosamente;
finemente===finemente;
socialmente===socialmente;
improvvidamente===improvvidamente;
fotostaticamente===fotostaticamente;
audiovisivamente===audiovisivamente;
implacabilmente===implacabilmente;
esigentemente===esigentemente;
allegramente===allegramente;
giullarescamente===giullarescamente;
apprezzabilmente===apprezzabilmente;
incensurabilmente===incensurabilmente;
discontinuamente===discontinuamente;
contemporaneamente===contemporaneamente;
pedestremente===pedestremente;
competentemente===competentemente;
irreperibilmente===irreperibilmente;
riflessivamente===riflessivamente;
separatemente===separatemente;
indefinibilmente===indefinibilmente;
circa===circa;
mnemonicamente===mnemonicamente;
beceramente===beceramente;
omogeneamente===omogeneamente;
sprovvedutamente===sprovvedutamente;
esasperantemente===esasperantemente;
responsabilmente===responsabilmente;
confermativamente===confermativamente;
improrogabilmente===improrogabilmente;
genealogicamente===genealogicamente;
dimensionalmente===dimensionalmente;
coscientemente===coscientemente;
inconciliabilmente===inconciliabilmente;
proforma===proforma;
ferreamente===ferreamente;
temerariamente===temerariamente;
babelicamente===babelicamente;
immedicabilmente===immedicabilmente;
civilmente===civilmente;
incorruttibilmente===incorruttibilmente;
nientemeno===nientemeno;
terribilmente===terribilmente;
distinguibilmente===distinguibilmente;
cavallerescamente===cavallerescamente;
rigorosamente===rigorosamente;
fittiziamente===fittiziamente;
stenograficamente===stenograficamente;
vigliaccamente===vigliaccamente;
imperdonabilmente===imperdonabilmente;
leziosamente===leziosamente;
ereticamente===ereticamente;
rilassatamente===rilassatamente;
neoclassicamente===neoclassicamente;
verticalmente===verticalmente;
pieghevolmente===pieghevolmente;
limitativamente===limitativamente;
cartograficamente===cartograficamente;
campestremente===campestremente;
ignominiosamente===ignominiosamente;
trucemente===trucemente;
metafisicamente===metafisicamente;
logicamente===logicamente;
fruttuosamente===fruttuosamente;
assennatamente===assennatamente;
elusivamente===elusivamente;
distante===distante;
etnocentricamente===etnocentricamente;
immutabilmente===immutabilmente;
graziosamente===graziosamente;
giusto===giusto;
populisticamente===populisticamente;
onorabilmente===onorabilmente;
avventatamente===avventatamente;
iterativamente===iterativamente;
continuamente===continuamente;
placabilmente===placabilmente;
egemonicamente===egemonicamente;
attamente===attamente;
convulsamente===convulsamente;
fondamentalmente===fondamentalmente;
edittalmente===edittalmente;
approssimativamente===approssimativamente;
interpartiticamente===interpartiticamente;
penzoloni===penzoloni;
impenetrabilmente===impenetrabilmente;
angolarmente===angolarmente;
irresolutamente===irresolutamente;
bovinamente===bovinamente;
ladronescamente===ladronescamente;
prima===prima;
estemporaneamente===estemporaneamente;
ferinamente===ferinamente;
dettagliatamente===dettagliatamente;
impercettibilmente===impercettibilmente;
penalmente===penalmente;
sotto===sotto;
artefattamente===artefattamente;
liscio===liscio;
impetuosamente===impetuosamente;
corrispondentemente===corrispondentemente;
primitivamente===primitivamente;
colposamente===colposamente;
comparabilmente===comparabilmente;
nostalgicamente===nostalgicamente;
corrucciatamente===corrucciatamente;
sporadicamente===sporadicamente;
ammirativamente===ammirativamente;
alternatamente===alternatamente;
maestosamente===maestosamente;
evidentemente===evidentemente;
addirittura===addirittura;
corporativamente===corporativamente;
smaniosamente===smaniosamente;
nativamente===nativamente;
cerebralmente===cerebralmente;
inevitabilmente===inevitabilmente;
esecrabilmente===esecrabilmente;
abiettamente===abiettamente;
solidalmente===solidalmente;
pensierosamente===pensierosamente;
ergonomicamente===ergonomicamente;
desiosamente===desiosamente;
immondamente===immondamente;
illegalmente===illegalmente;
discrezionalmente===discrezionalmente;
concettualmente===concettualmente;
gergalmente===gergalmente;
incrollabilmente===incrollabilmente;
mica===mica;
poco===poco;
complicatamente===complicatamente;
innaturalmente===innaturalmente;
morbosamente===morbosamente;
genericamente===genericamente;
voltoloni===voltoloni;
biblicamente===biblicamente;
deliziosamente===deliziosamente;
filogeneticamente===filogeneticamente;
deduttivamente===deduttivamente;
sottofascia===sottofascia;
reversibilmente===reversibilmente;
orizzontalmente===orizzontalmente;
idroliticamente===idroliticamente;
fastosamente===fastosamente;
meditatamente===meditatamente;
indubbiamente===indubbiamente;
lacrimevolmente===lacrimevolmente;
fittamente===fittamente;
novellamente===novellamente;
scandalosamente===scandalosamente;
telepaticamente===telepaticamente;
intollerabilmente===intollerabilmente;
esacerbatamente===esacerbatamente;
linearmente===linearmente;
contentamente===contentamente;
interpretativamente===interpretativamente;
ponderatamente===ponderatamente;
talora===talora;talor;
aforisticamente===aforisticamente;
bellamente===bellamente;
cupamente===cupamente;
ignorantemente===ignorantemente;
coreograficamente===coreograficamente;
profondamente===profondamente;
sozzamente===sozzamente;
spregiativamente===spregiativamente;
strenuamente===strenuamente;
compiutamente===compiutamente;
anzitempo===anzitempo;
mitemente===mitemente;
indeterminatamente===indeterminatamente;
inalienabilmente===inalienabilmente;
irrealisticamente===irrealisticamente;
onninamente===onninamente;
spaziosamente===spaziosamente;
castigatamente===castigatamente;
ombrosamente===ombrosamente;
avaramente===avaramente;
impudicamente===impudicamente;
sempre===sempre;
stizzosamente===stizzosamente;
disdegnosamente===disdegnosamente;
indecifrabilmente===indecifrabilmente;
praticabilmente===praticabilmente;
immaginabilmente===immaginabilmente;
sacrosantamente===sacrosantamente;
stentatamente===stentatamente;
balzelloni===balzelloni;
messianicamente===messianicamente;
pregiudizievolmente===pregiudizievolmente;
puntigliosamente===puntigliosamente;
internazionalmente===internazionalmente;
ostinatamente===ostinatamente;
lusinghieramente===lusinghieramente;
purtroppo===purtroppo;
infinitesimamente===infinitesimamente;
istintivamente===istintivamente;
tecnologicamente===tecnologicamente;
esclamativamente===esclamativamente;
nobilmente===nobilmente;
morigeratamente===morigeratamente;
sottomano===sottomano;
prettamente===prettamente;
facilmente===facilmente;
lucrosamente===lucrosamente;
brillantemente===brillantemente;
malincuore===malincuore;
abbottonatamente===abbottonatamente;
consensualmente===consensualmente;
doverosamente===doverosamente;
immaturamente===immaturamente;
indivisibilmente===indivisibilmente;
cognitivamente===cognitivamente;
ovunque===ovunque;
limpidamente===limpidamente;
sanguinosamente===sanguinosamente;
pragmaticamente===pragmaticamente;
arcignamente===arcignamente;
intellettivamente===intellettivamente;
poc'anzi===poc'anzi;
arcanamente===arcanamente;
irrealizzabilmente===irrealizzabilmente;
istrionescamente===istrionescamente;
immensurabilmente===immensurabilmente;
concitatamente===concitatamente;
malignosamente===malignosamente;
drittamente===drittamente;
docilmente===docilmente;
altronde===altronde;
costruttivamente===costruttivamente;
insensibilmente===insensibilmente;
ragionevolmente===ragionevolmente;
simbolicamente===simbolicamente;
ambulatorialmente===ambulatorialmente;
insolentemente===insolentemente;
oltremisura===oltremisura;
perifrasticamente===perifrasticamente;
ontogeneticamente===ontogeneticamente;
farisaicamente===farisaicamente;
pazzamente===pazzamente;
nazionalisticamente===nazionalisticamente;
inalterabilmente===inalterabilmente;
inconsuetamente===inconsuetamente;
tecnicamente===tecnicamente;
tuttavolta===tuttavolta;
affinemente===affinemente;
anteriormente===anteriormente;
estaticamente===estaticamente;
interamente===interamente;
introspettivamente===introspettivamente;
torvamente===torvamente;
edificantemente===edificantemente;
superficialmente===superficialmente;
ingiustamente===ingiustamente;
erroneamente===erroneamente;
ermeticamente===ermeticamente;
incantevolmente===incantevolmente;
cupidamente===cupidamente;
all'interno===all'interno;
negativamente===negativamente;
piagnucolosamente===piagnucolosamente;
meritocraticamente===meritocraticamente;
innocuamente===innocuamente;
tosto===tosto;
primieramente===primieramente;
acusticamente===acusticamente;
dianzi===dianzi;
pienamente===pienamente;
dappresso===dappresso;
soteriologicamente===soteriologicamente;
volentierissimo===volentierissimo;
grottescamente===grottescamente;
mediamente===mediamente;
rognosamente===rognosamente;
difettosamente===difettosamente;
cromaticamente===cromaticamente;
atavicamente===atavicamente;
lubricamente===lubricamente;
temibilmente===temibilmente;
lenemente===lenemente;
geologicamente===geologicamente;
intricatamente===intricatamente;
imperfettamente===imperfettamente;
nervosamente===nervosamente;
ove===ove;
immaginosamente===immaginosamente;
gelidamente===gelidamente;
caporiverso===caporiverso;
recentissimamente===recentissimamente;
inurbanamente===inurbanamente;
frammentariamente===frammentariamente;
intorno===intorno;
cruentemente===cruentemente;
via===via;
marzialmente===marzialmente;
anelantemente===anelantemente;
inconcludentemente===inconcludentemente;
compassatamente===compassatamente;
epidermicamente===epidermicamente;
potentemente===potentemente;
nazionalmente===nazionalmente;
opinabilmente===opinabilmente;
visibilmente===visibilmente;
igienicamente===igienicamente;
maschiamente===maschiamente;
galatticamente===galatticamente;
adeguatamente===adeguatamente;
interinalmente===interinalmente;
sottovela===sottovela;
freudianamente===freudianamente;
etnograficamente===etnograficamente;
spiccatamente===spiccatamente;
diabolicamente===diabolicamente;
maledettamente===maledettamente;
modestamente===modestamente;
davanti===davanti;
sfavorevolmente===sfavorevolmente;
tranquillamente===tranquillamente;
causticamente===causticamente;
crucciatamente===crucciatamente;
normativamente===normativamente;
fideisticamente===fideisticamente;
confessionalmente===confessionalmente;
insubordinatamente===insubordinatamente;
molto===molto;
tassativamente===tassativamente;
peccaminosamente===peccaminosamente;
contemplativamente===contemplativamente;
probabilisticamente===probabilisticamente;
parodicamente===parodicamente;
meccanicamente===meccanicamente;
attivisticamente===attivisticamente;
inauditamente===inauditamente;
conflittualmente===conflittualmente;
talmente===talmente;
comunemente===comunemente;
incontentabilmente===incontentabilmente;
forbitamente===forbitamente;
invidiosamente===invidiosamente;
passivamente===passivamente;
ora===ora;
catastroficamente===catastroficamente;
gentilmente===gentilmente;
speciosamente===speciosamente;
monodicamente===monodicamente;
inflessibilmente===inflessibilmente;
presuntivamente===presuntivamente;
schiettamente===schiettamente;
pitagoricamente===pitagoricamente;
cumulativamente===cumulativamente;
miracolosamente===miracolosamente;
stamane===stamane;
oculatamente===oculatamente;
stamani===stamani;
compattamente===compattamente;
decisamente===decisamente;
all'istante===all'istante;
incorreggibilmente===incorreggibilmente;
preziosamente===preziosamente;
grossomodo===grossomodo;
indicativamente===indicativamente;
laddove===laddove;
alquanto===alquanto;
sensatamente===sensatamente;
mendicamente===mendicamente;
bizzosamente===bizzosamente;
profumatamente===profumatamente;
precauzionalmente===precauzionalmente;
carezzevolmente===carezzevolmente;
nientedimeno===nientedimeno;nientepopodimeno;
continuatamente===continuatamente;
battericamente===battericamente;
catarticamente===catarticamente;
intelligentemente===intelligentemente;
minutamente===minutamente;
previdentemente===previdentemente;
ordinariamente===ordinariamente;
diretto===diretto;
incompatibilmente===incompatibilmente;
delicatamente===delicatamente;
finalmente===finalmente;
meritoriamente===meritoriamente;
aritmeticamente===aritmeticamente;
tendenzialmente===tendenzialmente;
similarmente===similarmente;
egoisticamente===egoisticamente;
istantaneamente===istantaneamente;
coralmente===coralmente;
intensamente===intensamente;
bruscamente===bruscamente;
comprensibilmente===comprensibilmente;
avantieri===avantieri;
egotisticamente===egotisticamente;
circospettamente===circospettamente;
sicuramente===sicuramente;
discorsivamente===discorsivamente;
gradualmente===gradualmente;
spericolatamente===spericolatamente;
lugubremente===lugubremente;
nominalmente===nominalmente;
leggermente===leggermente;
lessicologicamente===lessicologicamente;
insopprimibilmente===insopprimibilmente;
sinfonicamente===sinfonicamente;
dentro===dentro;dentr;
sottinsù===sottinsù;
infaticabilmente===infaticabilmente;
prolissamente===prolissamente;
estesamente===estesamente;
ridosso===ridosso;
cautelarmente===cautelarmente;
timorosamente===timorosamente;
sinuosamente===sinuosamente;
sull'unghia===sull'unghia;
agiatamente===agiatamente;
fioritamente===fioritamente;
dinasticamente===dinasticamente;
apertamente===apertamente;
economicamente===economicamente;
inarrivabilmente===inarrivabilmente;
persistentemente===persistentemente;
fisicamente===fisicamente;
fedelmente===fedelmente;
piuttosto===piuttosto;
dorsalmente===dorsalmente;
sorprendentemente===sorprendentemente;
irregolarmente===irregolarmente;
oltreoceano===oltreoceano;
archeologicamente===archeologicamente;
flagrantemente===flagrantemente;
felinamente===felinamente;
fuoripasto===fuoripasto;
introduttivamente===introduttivamente;
apocalitticamente===apocalitticamente;
straordinariamente===straordinariamente;
aristotelicamente===aristotelicamente;
quantitativamente===quantitativamente;
armacollo===armacollo;
dirittamente===dirittamente;
manchevolmente===manchevolmente;
vilmente===vilmente;
arduamente===arduamente;
compatibilmente===compatibilmente;
esotericamente===esotericamente;
alteramente===alteramente;
incompetentemente===incompetentemente;
elevatamente===elevatamente;
prospetticamente===prospetticamente;
stabilmente===stabilmente;
maternamente===maternamente;
d'altronde===d'altronde;
malintenzionatamente===malintenzionatamente;
macroscopicamente===macroscopicamente;
affabilmente===affabilmente;
pomposamente===pomposamente;
prosperosamente===prosperosamente;
ruzzoloni===ruzzoloni;
indirettamentente===indirettamentente;
personalmente===personalmente;
sventuratamente===sventuratamente;
egregiamente===egregiamente;
equamente===equamente;
sconfinatamente===sconfinatamente;
temporaneamente===temporaneamente;
testualmente===testualmente;
eufonicamente===eufonicamente;
prosaicamente===prosaicamente;
competitivamente===competitivamente;
inesattamente===inesattamente;
antieconomicamente===antieconomicamente;
irriducibilmente===irriducibilmente;
generalmente===generalmente;
irriguardosamente===irriguardosamente;
immobilisticamente===immobilisticamente;
impagabilmente===impagabilmente;
enfaticamente===enfaticamente;
sentenziosamente===sentenziosamente;
cattolicamente===cattolicamente;
asocialmente===asocialmente;
balzanamente===balzanamente;
eccezionalmente===eccezionalmente;
tediosamente===tediosamente;
lealmente===lealmente;
barbosamente===barbosamente;
vanagloriosamente===vanagloriosamente;
voracemente===voracemente;
magniloquentemente===magniloquentemente;
reiteratamente===reiteratamente;
romanamente===romanamente;
cameratescamente===cameratescamente;
sconsolatamente===sconsolatamente;
totalmente===totalmente;
inosservatamente===inosservatamente;
poveramente===poveramente;
vastamente===vastamente;
variabilmente===variabilmente;
iersera===iersera;
cavillosamente===cavillosamente;
benone===benone;
amleticamente===amleticamente;
realisticamente===realisticamente;
costaggiù===costaggiù;
calunniosamente===calunniosamente;
modulatamente===modulatamente;
dialetticamente===dialetticamente;
giornalmente===giornalmente;
irrazionalmente===irrazionalmente;
latamente===latamente;
nitidamente===nitidamente;
ufficiosamente===ufficiosamente;
amorevolmente===amorevolmente;
autocriticamente===autocriticamente;
confortabilmente===confortabilmente;
sommariamente===sommariamente;
convulsivamente===convulsivamente;
contenziosamente===contenziosamente;
ansiosamente===ansiosamente;
giocoforza===giocoforza;
imparzialmente===imparzialmente;
pittorescamente===pittorescamente;
abnormemente===abnormemente;
scurrilmente===scurrilmente;
autarchicamente===autarchicamente;
legislativamente===legislativamente;
esteriormente===esteriormente;
pappagallescamente===pappagallescamente;
espansivamente===espansivamente;
dintorno===dintorno;
politicamente===politicamente;
saccentemente===saccentemente;
illegittimamente===illegittimamente;
frontalmente===frontalmente;
essotericamente===essotericamente;
ventosamente===ventosamente;
biograficamente===biograficamente;
remissivamente===remissivamente;
emblematicamente===emblematicamente;
maliziosamente===maliziosamente;
indosso===indosso;
integrativamente===integrativamente;
succosamente===succosamente;
incessabilmente===incessabilmente;
sicuro===sicuro;
strambamente===strambamente;
equitativamente===equitativamente;
attraverso===attraverso;
affettivamente===affettivamente;
visivamente===visivamente;
languidamente===languidamente;
psichicamente===psichicamente;
logisticamente===logisticamente;
iratamente===iratamente;
pigramente===pigramente;
formidabilmente===formidabilmente;
volubilmente===volubilmente;
fenomenologicamente===fenomenologicamente;
erratamente===erratamente;
stravagantemente===stravagantemente;
inimmaginabilmente===inimmaginabilmente;
finitamente===finitamente;
avidamente===avidamente;
esoticamente===esoticamente;
giurisdizionalmente===giurisdizionalmente;
specificatamente===specificatamente;
paurosamente===paurosamente;
amabilmente===amabilmente;
bravamente===bravamente;
irrevocabilmente===irrevocabilmente;
popolarmente===popolarmente;
comparatamente===comparatamente;
all'impazzata===all'impazzata;
frivolamente===frivolamente;
riottosamente===riottosamente;
irresolubilmente===irresolubilmente;
sottobraccio===sottobraccio;
confidenzialmente===confidenzialmente;
convenzionalmente===convenzionalmente;
proverbialmente===proverbialmente;
esilmente===esilmente;
assolutamente===assolutamente;
lerciamente===lerciamente;
febbrilmente===febbrilmente;
angustamente===angustamente;
inguaribilmente===inguaribilmente;
irrefrenabilmente===irrefrenabilmente;
appetto===appetto;
castamente===castamente;
essenzialmente===essenzialmente;
pacificamente===pacificamente;
interlocutoriamente===interlocutoriamente;
cenobiticamente===cenobiticamente;
occasionalmente===occasionalmente;
goliardicamente===goliardicamente;
irrecuperabilmente===irrecuperabilmente;
didascalicamente===didascalicamente;
corrosivamente===corrosivamente;
ricercatamente===ricercatamente;
pugnacemente===pugnacemente;
globalmente===globalmente;
maluccio===maluccio;
riecco===riecco;
ipocritamente===ipocritamente;
funzionalmente===funzionalmente;
accanitamente===accanitamente;
atemporalmente===atemporalmente;
inegualmente===inegualmente;
soavemente===soavemente;
premeditatamente===premeditatamente;
ripidamente===ripidamente;
rotoloni===rotoloni;
casualmente===casualmente;
proletticamente===proletticamente;
dattorno===dattorno;
promiscuamente===promiscuamente;
fuggevolmente===fuggevolmente;
follemente===follemente;
cataliticamente===cataliticamente;
flebilmente===flebilmente;
violentamente===violentamente;
pruriginosamente===pruriginosamente;
acrobaticamente===acrobaticamente;
incruentemente===incruentemente;
patriotticamente===patriotticamente;
colà===colà;
scriteriatamente===scriteriatamente;
fievolmente===fievolmente;
romanticamente===romanticamente;
classicamente===classicamente;
all'ingrosso===all'ingrosso;
disorganizzatamente===disorganizzatamente;
opportunamente===opportunamente;
ottusamente===ottusamente;
vaporosamente===vaporosamente;
grossolanamente===grossolanamente;
inqualificabilmente===inqualificabilmente;
fortissimamente===fortissimamente;
soltanto===soltanto;
vacuamente===vacuamente;
aristocraticamente===aristocraticamente;
lungi===lungi;
saviamente===saviamente;
patologicamente===patologicamente;
arzigogolatamente===arzigogolatamente;
diffusamente===diffusamente;
stoicamente===stoicamente;
callidamente===callidamente;
impietosamente===impietosamente;
all'aperto===all'aperto;
isolatamente===isolatamente;
irrisoriamente===irrisoriamente;
capziosamente===capziosamente;
forfettariamente===forfettariamente;
salatamente===salatamente;
insperatamente===insperatamente;
gioiosamente===gioiosamente;
aperiodicamente===aperiodicamente;
deliberatamente===deliberatamente;
sfacciatamente===sfacciatamente;
decorativamente===decorativamente;
fatiscentemente===fatiscentemente;
irosamente===irosamente;
barcolloni===barcolloni;
altrettanto===altrettanto;
marginalmente===marginalmente;
conseguenzialmente===conseguenzialmente;
insipientemente===insipientemente;
disumanamente===disumanamente;
oziosamente===oziosamente;
dittatorialmente===dittatorialmente;
come===come;com';
tardivamente===tardivamente;
immensamente===immensamente;
irrimediabilmente===irrimediabilmente;
intrigantemente===intrigantemente;
pietosamente===pietosamente;
fatalisticamente===fatalisticamente;
fintamente===fintamente;
inaccettabilmente===inaccettabilmente;
dermatologicamente===dermatologicamente;
intollerantemente===intollerantemente;
intransigentemente===intransigentemente;
conservativamente===conservativamente;
moralmente===moralmente;
sbrigativamente===sbrigativamente;
pretestuosamente===pretestuosamente;
spartanamente===spartanamente;
superfluamente===superfluamente;
effeminatamente===effeminatamente;
emotivamente===emotivamente;
cantabile===cantabile;
indolentemente===indolentemente;
categoricamente===categoricamente;
sperticatamente===sperticatamente;
scontrosamente===scontrosamente;
conciliantemente===conciliantemente;
restrittivamente===restrittivamente;
consciamente===consciamente;
incoerentemente===incoerentemente;
diritto===diritto;
conciliabilmente===conciliabilmente;
domesticamente===domesticamente;
controvento===controvento;contravvento;
spettacolosamente===spettacolosamente;
ostentatamente===ostentatamente;
opzionalmente===opzionalmente;
supplichevolmente===supplichevolmente;
sugosamente===sugosamente;
selvaticamente===selvaticamente;
testardamente===testardamente;
copertamente===copertamente;
omologamente===omologamente;
inconoscibilmente===inconoscibilmente;
profittevolmente===profittevolmente;
inaccessibilmente===inaccessibilmente;
gradatamente===gradatamente;
giustificabilmente===giustificabilmente;
faticosamente===faticosamente;
accelerando===accelerando;
tuttora===tuttora;
stavolta===stavolta;
comunalmente===comunalmente;
sonnacchiosamente===sonnacchiosamente;
screanzatamente===screanzatamente;
distruttivamente===distruttivamente;
crucciosamente===crucciosamente;
morfosintatticamente===morfosintatticamente;
esasperatamente===esasperatamente;
amministrativamente===amministrativamente;
vagamente===vagamente;
pubblicamente===pubblicamente;
energeticamente===energeticamente;
sussiegosamente===sussiegosamente;
frettolosamente===frettolosamente;
planimetricamente===planimetricamente;
suggestivamente===suggestivamente;
grammaticalmente===grammaticalmente;
epistemologicamente===epistemologicamente;
avversamente===avversamente;
inconfondibilmente===inconfondibilmente;
foneticamente===foneticamente;
ossequiosamente===ossequiosamente;
accaloratamente===accaloratamente;
sporcamente===sporcamente;
incostantemente===incostantemente;
impegnativamente===impegnativamente;
scorrettamente===scorrettamente;
spassosamente===spassosamente;
astronomicamente===astronomicamente;
subito===subito;
fantasiosamente===fantasiosamente;
consecutivamente===consecutivamente;
bislaccamente===bislaccamente;
scaltramente===scaltramente;
risibilmente===risibilmente;
schizzinosamente===schizzinosamente;
iteratamente===iteratamente;
immemorabilmente===immemorabilmente;
nevroticamente===nevroticamente;
privatamente===privatamente;
tremendamente===tremendamente;
faustamente===faustamente;
consuntamente===consuntamente;
malvagiamente===malvagiamente;
insidiosamente===insidiosamente;
eremiticamente===eremiticamente;
avant'ieri===avant'ieri;
ugualmente===ugualmente;
contabilmente===contabilmente;
nudamente===nudamente;
inesorabilmente===inesorabilmente;
immisurabilmente===immisurabilmente;
spaventosamente===spaventosamente;
inavvedutamente===inavvedutamente;
sarcasticamente===sarcasticamente;
sperimentalmente===sperimentalmente;
impersonalmente===impersonalmente;
disgiuntamente===disgiuntamente;
apicalmente===apicalmente;
volgarmente===volgarmente;
pecorescamente===pecorescamente;
urbanamente===urbanamente;
virilmente===virilmente;
indicibilmente===indicibilmente;
immodificabilmente===immodificabilmente;
pretenziosamente===pretenziosamente;
languorosamente===languorosamente;
disarticolatamente===disarticolatamente;
prevalentemente===prevalentemente;
annoiatamente===annoiatamente;
localmente===localmente;
minacciosamente===minacciosamente;
interregionalmente===interregionalmente;
incongruamente===incongruamente;
tipicamente===tipicamente;
dappertutto===dappertutto;
attraentemente===attraentemente;
platealmente===platealmente;
evasivamente===evasivamente;
pesantemente===pesantemente;
diagnosticamente===diagnosticamente;
sartorialmente===sartorialmente;
disordinatamente===disordinatamente;
boriosamente===boriosamente;
naturalisticamente===naturalisticamente;
scivolosamente===scivolosamente;
avaccio===avaccio;
incirca===incirca;
esternamente===esternamente;
tassonomicamente===tassonomicamente;
sottosopra===sottosopra;
neglettamente===neglettamente;
sublimemente===sublimemente;
grevemente===grevemente;
pessimamente===pessimamente;
lateralmente===lateralmente;
finanziariamente===finanziariamente;
bilateralmente===bilateralmente;
giudiziariamente===giudiziariamente;
ripetitivamente===ripetitivamente;
illiberalmente===illiberalmente;
genialmente===genialmente;
superiormente===superiormente;
ossessivamente===ossessivamente;
sfrenatamente===sfrenatamente;
macabramente===macabramente;
paternamente===paternamente;
apaticamente===apaticamente;
peggiormente===peggiormente;
briosamente===briosamente;
democraticamente===democraticamente;
speranzosamente===speranzosamente;
semplicisticamente===semplicisticamente;
espressamente===espressamente;
viziosamente===viziosamente;
dinamicamente===dinamicamente;
prossimalmente===prossimalmente;
subdolamente===subdolamente;
cattivamente===cattivamente;
ingiuriosamente===ingiuriosamente;
panciolle===panciolle;
precisamente===precisamente;
eccelsamente===eccelsamente;
anarchicamente===anarchicamente;
pregnantemente===pregnantemente;
inopinatamente===inopinatamente;
positivamente===positivamente;
partecipativamente===partecipativamente;
incostituzionalmente===incostituzionalmente;
rigidamente===rigidamente;
vattelapesca===vattelapesca;
fervidamente===fervidamente;
umoristicamente===umoristicamente;
letalmente===letalmente;
radicalmente===radicalmente;
lestamente===lestamente;
dicotomicamente===dicotomicamente;
mai===mai;
ideologicamente===ideologicamente;
sanamente===sanamente;
fotogenicamente===fotogenicamente;
anagogicamente===anagogicamente;
prelibatamente===prelibatamente;
oltremodo===oltremodo;
addì===addì;
giornalisticamente===giornalisticamente;
lautamente===lautamente;
quando===quando;quand';
radialmente===radialmente;
allegoricamente===allegoricamente;
freddolosamente===freddolosamente;
inscrutabilmente===inscrutabilmente;
impensabilmente===impensabilmente;
elettricamente===elettricamente;
beninteso===beninteso;
unilateralmente===unilateralmente;
pallosamente===pallosamente;
liturgicamente===liturgicamente;
minerariamente===minerariamente;
automagicamente===automagicamente;
catastalmente===catastalmente;
ingentemente===ingentemente;
gradevolmente===gradevolmente;
infrasettimanalmente===infrasettimanalmente;
lindamente===lindamente;
esclusivamente===esclusivamente;
amenamente===amenamente;
pedissequamente===pedissequamente;
elegantemente===elegantemente;
contrassegno===contrassegno;
cadavericamente===cadavericamente;
merceologicamente===merceologicamente;
calcisticamente===calcisticamente;
insanabilmente===insanabilmente;
eruditamente===eruditamente;
discretamente===discretamente;
accortamente===accortamente;
autocraticamente===autocraticamente;
misericordiosamente===misericordiosamente;
rissosamente===rissosamente;
giustappunto===giustappunto;
piacentemente===piacentemente;
percentualmente===percentualmente;
futilmente===futilmente;
inoppugnabilmente===inoppugnabilmente;
ingordamente===ingordamente;
strasciconi===strasciconi;
beatamente===beatamente;
bisettimanalmente===bisettimanalmente;
risentitamente===risentitamente;
tragicamente===tragicamente;
ingloriosamente===ingloriosamente;
determinatamente===determinatamente;
islamicamente===islamicamente;
sadicamente===sadicamente;
pacatamente===pacatamente;
ignobilmente===ignobilmente;
pazzescamente===pazzescamente;
dichiaratamente===dichiaratamente;
affrettatamente===affrettatamente;
mosciamente===mosciamente;
alogicamente===alogicamente;
gattoni===gattoni;
macchinalmente===macchinalmente;
disastrosamente===disastrosamente;
psicoterapeuticamente===psicoterapeuticamente;
immeritatamente===immeritatamente;
frequentemente===frequentemente;
affatto===affatto;
scompostamente===scompostamente;
atomicamente===atomicamente;
vistosamente===vistosamente;
agiograficamente===agiograficamente;
gravitazionalmente===gravitazionalmente;
pateticamente===pateticamente;
altruisticamente===altruisticamente;
sveltamente===sveltamente;
accidentalmente===accidentalmente;
ingiustificatamente===ingiustificatamente;
desiderabilmente===desiderabilmente;
almeno===almeno;almen;
crittograficamente===crittograficamente;
incompostamente===incompostamente;
anaforicamente===anaforicamente;
all'inizio===all'inizio;
precipitosamente===precipitosamente;
ingovernabilmente===ingovernabilmente;
immoderatamente===immoderatamente;
diuturnamente===diuturnamente;
scioltamente===scioltamente;
trascuratamente===trascuratamente;
mobilmente===mobilmente;
maritalmente===maritalmente;
imperituramente===imperituramente;
visualmente===visualmente;
scabrosamente===scabrosamente;
appartatamente===appartatamente;
curricularmente===curricularmente;
minuziosamente===minuziosamente;
ghiottamente===ghiottamente;
senz'altro===senz'altro;
esemplificativamente===esemplificativamente;
sommessamente===sommessamente;
ambiziosamente===ambiziosamente;
circostanziatamente===circostanziatamente;
fertilmente===fertilmente;
disarmonicamente===disarmonicamente;
acerrimamente===acerrimamente;
facoltosamente===facoltosamente;
indistintamente===indistintamente;
asimmetricamente===asimmetricamente;
segnatamente===segnatamente;
indisciplinatamente===indisciplinatamente;
scelleratamente===scelleratamente;
infantilmente===infantilmente;
lussuosamente===lussuosamente;
inizialmente===inizialmente;
letterariamente===letterariamente;
dilettevolmente===dilettevolmente;
furiosamente===furiosamente;
condizionatamente===condizionatamente;
crudelmente===crudelmente;
intransitivamente===intransitivamente;
sociologicamente===sociologicamente;
intensivamente===intensivamente;
rispettabilmente===rispettabilmente;
fantasticamente===fantasticamente;
temperatamente===temperatamente;
appresso===appresso;
tantomeno===tantomeno;
parcamente===parcamente;
immantinente===immantinente;immantenente;
vosco===vosco;
merdosamente===merdosamente;
acrimoniosamente===acrimoniosamente;
pendolarmente===pendolarmente;
vituperosamente===vituperosamente;
vischiosamente===vischiosamente;
imprescrittibilmente===imprescrittibilmente;
approfonditamente===approfonditamente;
possessivamente===possessivamente;
omoritimicamente===omoritimicamente;
ellenisticamente===ellenisticamente;
causalmente===causalmente;
elettroliticamente===elettroliticamente;
ancora===ancora;ancor;
fotozincograficamente===fotozincograficamente;
austeramente===austeramente;
mutamente===mutamente;
trasversalmente===trasversalmente;traversalmente;
vigorosamente===vigorosamente;
cineticamente===cineticamente;
univocamente===univocamente;
bigottamente===bigottamente;
paternalisticamente===paternalisticamente;
accidiosamente===accidiosamente;
fiscalmente===fiscalmente;
facoltativamente===facoltativamente;
imperativamente===imperativamente;
esaustivamente===esaustivamente;
analogicamente===analogicamente;
dolcemente===dolcemente;
alpinisticamente===alpinisticamente;
sentitamente===sentitamente;
empaticamente===empaticamente;
largamente===largamente;
saggiamente===saggiamente;
inettamente===inettamente;
presentemente===presentemente;
uguale===uguale;
cacofonicamente===cacofonicamente;
insonnemente===insonnemente;
prodigalmente===prodigalmente;
saporitamente===saporitamente;
fotolitograficamente===fotolitograficamente;
recisamente===recisamente;
astrusamente===astrusamente;
sfiziosamente===sfiziosamente;
intrepidamente===intrepidamente;
esecutivamente===esecutivamente;
abusivamente===abusivamente;
abbondantemente===abbondantemente;
autenticamente===autenticamente;
allegretto===allegretto;
caratterologicamente===caratterologicamente;
decentemente===decentemente;
agamicamente===agamicamente;
trimestralmente===trimestralmente;
bisognosamente===bisognosamente;
esaltantemente===esaltantemente;
addietro===addietro;
precipitatamente===precipitatamente;
poliedricamente===poliedricamente;
transattivamente===transattivamente;
debolmente===debolmente;
rapidamente===rapidamente;
laggiù===laggiù;
verbigrazia===verbigrazia;
particolarmente===particolarmente;
putacaso===putacaso;
putativamente===putativamente;
stiracchiatamente===stiracchiatamente;
molestamente===molestamente;
neghittosamente===neghittosamente;
tardi===tardi;
sessualmente===sessualmente;
melensamente===melensamente;
iconograficamente===iconograficamente;
convincentemente===convincentemente;
ipoteticamente===ipoteticamente;
accigliatamente===accigliatamente;
plasticamente===plasticamente;
prontamente===prontamente;
inconfutabilmente===inconfutabilmente;
appiccicosamente===appiccicosamente;
quanto===quanto;quant';
preliminarmente===preliminarmente;
costinci===costinci;
dolorosamente===dolorosamente;
infaustamente===infaustamente;
abiologicamente===abiologicamente;
integramente===integramente;
indiscriminatamente===indiscriminatamente;
indelicatamente===indelicatamente;
spregevolmente===spregevolmente;
commiserabilmente===commiserabilmente;
potenzialmente===potenzialmente;
tenebrosamente===tenebrosamente;
selvaggiamente===selvaggiamente;
gloriosamente===gloriosamente;
sott'olio===sott'olio;
goffamente===goffamente;
commiserevolmente===commiserevolmente;
imprevedibilmente===imprevedibilmente;
piacevolmente===piacevolmente;
aggraziatamente===aggraziatamente;
iosa===iosa;
costassù===costassù;
ellitticamente===ellitticamente;
definitamente===definitamente;
intrinsecamente===intrinsecamente;
spregiudicatamente===spregiudicatamente;
deprecabilmente===deprecabilmente;
capitalmente===capitalmente;
necroscopicamente===necroscopicamente;
dottorescamente===dottorescamente;
regalmente===regalmente;
impazientemente===impazientemente;
niente===niente;nient';
carismaticamente===carismaticamente;
seccamente===seccamente;
interscambiabilmente===interscambiabilmente;
schernevolmente===schernevolmente;
abominevolmente===abominevolmente;
pulito===pulito;
giulivamente===giulivamente;
contagiosamente===contagiosamente;
visceralmente===visceralmente;
maniacalmente===maniacalmente;
attendibilmente===attendibilmente;
chiaramente===chiaramente;
capricciosamente===capricciosamente;
verbalmente===verbalmente;
filantropicamente===filantropicamente;
velocemente===velocemente;
appetitosamente===appetitosamente;
precariamente===precariamente;
divinamente===divinamente;
auspicabilmente===auspicabilmente;
pattiziamente===pattiziamente;
covalentemente===covalentemente;
incurantemente===incurantemente;
divertentemente===divertentemente;
baroccamente===baroccamente;
proficuamente===proficuamente;
velatamente===velatamente;
stranamente===stranamente;
tortuosamente===tortuosamente;
vicino===vicino;
condensatamente===condensatamente;
dilettantescamente===dilettantescamente;
inintermediari===inintermediari;
tradizionalmente===tradizionalmente;
infondatamente===infondatamente;
piano===piano;pian;
congruamente===congruamente;
boccaccescamente===boccaccescamente;
villanamente===villanamente;
espressivamente===espressivamente;
teneramente===teneramente;
freneticamente===freneticamente;
antecedentemente===antecedentemente;
pressoché===pressoché;
imperterritamente===imperterritamente;
dritto===dritto;
altroché===altroché;
fragilmente===fragilmente;
allettantemente===allettantemente;
pericolosamente===pericolosamente;
esogamicamente===esogamicamente;
pressochè===pressochè;
incolpevolmente===incolpevolmente;
coloritamente===coloritamente;
drasticamente===drasticamente;
simmetricamente===simmetricamente;
metodicamente===metodicamente;
pinguemente===pinguemente;
variatamente===variatamente;
giovialmente===giovialmente;
immoralmente===immoralmente;
antropomorficamente===antropomorficamente;
enormemente===enormemente;
combattivamente===combattivamente;
fisso===fisso;
fugacemente===fugacemente;
velenosamente===velenosamente;
ingannevolmente===ingannevolmente;
mondanamente===mondanamente;
organizzativamente===organizzativamente;
eticamente===eticamente;
stucchevolmente===stucchevolmente;
contro===contro;
rocciosamente===rocciosamente;
giocosamente===giocosamente;
epicamente===epicamente;
insuperabilmente===insuperabilmente;
notevolmente===notevolmente;
bislungamente===bislungamente;
grintosamente===grintosamente;
fetidamente===fetidamente;
simbioticamente===simbioticamente;
centralmente===centralmente;
considerevolmente===considerevolmente;
metricamente===metricamente;
irreconciliabilmente===irreconciliabilmente;
irreparabilmente===irreparabilmente;
vicendevolmente===vicendevolmente;
vanamente===vanamente;
benauguratamente===benauguratamente;
polemicamente===polemicamente;
zonzo===zonzo;
complimentosamente===complimentosamente;
consideratamente===consideratamente;
cotanto===cotanto;
sottoprezzo===sottoprezzo;
misuratamente===misuratamente;
irrepugnabilmente===irrepugnabilmente;
sommamente===sommamente;
oggimai===oggimai;
pertinacemente===pertinacemente;
lietamente===lietamente;
riguardosamente===riguardosamente;
schifiltosamente===schifiltosamente;
descrittivamente===descrittivamente;
eccitatamente===eccitatamente;
clamorosamente===clamorosamente;
ridicolmente===ridicolmente;
ispidamente===ispidamente;
deplorabilmente===deplorabilmente;
etimologicamente===etimologicamente;
eroticamente===eroticamente;
intermittentemente===intermittentemente;
oggidì===oggidì;
mo'===mo';
