onde===onde;
oppure===oppure;
sebbene===sebbene;
solo===solo;
dappoi===dappoi;
seppure===seppure;seppur;
affinché===affinché;
affinchè===affinchè;
ancorchè===ancorchè;
&===&;
ancorché===ancorché;
acciocché===acciocché;
cioé===cioé;
salvo===salvo;
ché===ché;
talché===talché;
pure===pure;pur;
allorchè===allorchè;
ogniqualvolta===ogniqualvolta;
nonché===nonché;
nonchè===nonchè;
siccome===siccome;
e/o===e/o;
ovvero===ovvero;
fintantoché===fintantoché;fintantochè;
eziandio===eziandio;
cosicché===cosicché;
orbene===orbene;
benché===benché;benche;
sennonché===sennonché;
benchè===benchè;
ma===ma;
poichè===poichè;
poiché===poiché;
tant'è===tant'è;
e===e;
conciossiaché===conciossiaché;
sia===sia;
dopoché===dopoché;
quindi===quindi;
come===come;com';
o===o;
dopo===dopo;
quando===quando;quand';
perché===perché;
perchè===perchè;
allorquando===allorquando;
ora===ora;
sinché===sinché;
finchè===finchè;
finché===finché;
mentre===mentre;mentr;
tuttoché===tuttoché;
purché===purché;
dacché===dacché;
tuttavolta===tuttavolta;
imperocché===imperocché;
supposto===supposto;
ossia===ossia;
casomai===casomai;
magari===magari;
fuorchè===fuorchè;
acciò===acciò;
perciò===perciò;
fuorché===fuorché;
tantomeno===tantomeno;
giacché===giacché;
laddove===laddove;
giacchè===giacchè;
rispetto===rispetto;
pertanto===pertanto;
se===se;
dov'è===dov'è;
dove===dove;dov;
quandanche===quandanche;
tuttavia===tuttavia;
che===che;
qualvolta===qualvolta;
tanto===tanto;tant';
qualora===qualora;
sicché===sicché;sicchè;
né===né;
nè===nè;
semprechè===semprechè;
comunque===comunque;
però===però;
nonostante===nonostante;
intanto===intanto;
nondimeno===nondimeno;nondimen;
anzichè===anzichè;
ergo===ergo;
anziché===anziché;anziche;
bensì===bensì;
malgrado===malgrado;
neanche===neanche;neanch';
senza===senza;senz';
eppure===eppure;eppur;
dunque===dunque;adunque;
quantunque===quantunque;
viceversa===viceversa;
tantoché===tantoché;
