darinnen===-;darinnen
für alle Fälle===-;für alle Fälle
gerade===-;gerade;grad
händisch===-;händisch
noch nicht===-;noch nicht
denn==='n;denn
c.===⁊c.
etc.===⁊c.;etc.
a priori===a priori
a.===a.
aasig===aasig
ab und zu===ab und zu
abends===abends
aber===aber;zwar
abermals===abermals
abfällig===abfällig
abgesehen===abgesehen
abhanden===abhanden
absatzweise===absatzweise
abscheulich===abscheulich
abschließend===abschließend
abschnittweise===abschnittweise
absolut===absolut
abstrus===abstrus
hesitantly===abwartend
abwärts===abwärts
abweichend===abweichend
achtern===achtern
achtmal===achtmal
ackerbaulich===ackerbaulich
ad acta===ad acta
akkurat===akkurat
alle===alle
alle Jubeljahre===alle Jubeljahre
allegorisch===allegorisch
allein===allein;alleine
allemal===allemal
allenfalls===allenfalls
allerdings===allerdings
allerorten===allerorten
allerorts===allerorts
allerseits===allerseits
alles in allem===alles in allem
allmählich===allmählich;allmählig
allüberall===allüberall
allzu===allzu
allzuviel===allzuviel
als U-Boot leben===als U-Boot
alsbald===alsbald
alsdann===alsdann
alsdenn===alsdenn
also===also
am helllichten Tag===am hellichten Tag;am helllichten Tag
am offenen Herzen===am offenen Herzen
Amen===Amen
an Bord===an Bord
zur Seite===an die Seite;auf Seite;beiseite;zur Seite
an Sankt Nimmerlein===an Sankt Nimmerlein
an===an;hart
anatomisch===anatomisch
anbei===anbei
andernfalls===anderenfalls;andernfalls
andererseits===andererseits;andrerseits;zwar
andernorts===andernorts
anderntags===anderntags
anders===anders
anderseits===anderseits
andersherum===andersherum
andersrum===andersrum
anderswo===anderswo
anderwärts===anderwärts
aneinander===aneinander
anfangs===anfangs
angeblich===angeblich
anscheinend===anscheinend
anschließend===anschließend
ansonsten===ansonsten
apropos===apropos
ärgerlich===ärgerlich
arithmetisch===arithmetisch
auch===auch
auf Anhieb===auf Anhieb
auf Biegen und Brechen===auf Biegen und Brechen
haben===auf dem Kieker
auf dem Sterbebett===auf dem Sterbebett
auf den Beinen===auf den Beinen
auf den ersten Blick===auf den ersten Blick
auf den Tag===auf den Tag
auf den Tag genau===auf den Tag genau
auf der anderen Seite===auf der anderen Seite
auf der Kippe===auf der Kippe
auf eigene Faust===auf eigene Faust
auf einmal===auf einmal
auf Erden===auf Erden
auf jeden Fall===auf jeden Fall
auf links===auf links
auf Lunge===auf Lunge
auf Pump===auf Pump
auf Teufel komm raus===auf Teufel komm raus;auf Teufel-komm-raus
auf===auf;von heute auf morgen
aufdringlich===aufdringlich
aufeinander===aufeinander
auffallend===auffallend
auffällig===auffällig
aufs Neue===aufs Neue
aufwärts===aufwärts;bergauf
augenblicklich===augenblicklich
augenscheinlich===augenscheinlich
aus===aus
ausdrücklich===ausdrücklich
auseinander===auseinander
ausgeschrieben===ausgeschrieben
ausnahmsweise===ausnahmsweise
ausreichend===ausreichend
ausschließlich===ausschließlich
außen===außen
außerdem===außerdem
außerhalb===außerhalb
äußerlich===äußerlich
außerordentlich===außerordentlich
äußerst===äußerst
auswendig===auswendig
bald===bald
baldmöglichst===baldmöglichst
bar===bar
barfuß===barfuss
bäuchlings===bäuchlings
bauchoben===bauchoben
bedauerlicherweise===bedauerlicherweise
bedeutungsvoll===bedeutungsvoll
begreiflicherweise===begreiflicherweise
behelfsweise===behelfsweise
beide Mal===beidemal
beiderseits===beiderseits
beinah===beinah
beinahe===beinahe
beisammen===beisammen
beispielsweise===beispielsweise
beizeiten===beizeiten
bekanntlich===bekanntlich
beknackt===beknackt
beleidigt===beleidigt
bereits===bereits
bereitwillig===bereitwillig
bergab===bergab;bergauf
bergan===bergan;bergauf
uphill===bergauf
besonders===besonders
gut===besser;besten;gut
bestenfalls===bestenfalls
bestimmt===bestimmt
betrüblicherweise===betrüblicherweise
bezeichnenderweise===bezeichnenderweise
beziehungsweise===beziehungsweise
bildlich===bildlich
bis===bis jetzt
jetzt===bis jetzt;jetzt;jez
bisher===bisher
bislang===bislang
bisschen===bisschen
bisweilen===bißweilen;bißweylen;bisweilen;bisweylen
bitte===bitte;mal;vielleicht
bitter===bitter
bitterlich===bitterlich
bitweise===bitweise
blendend===blendend
blindlings===blindlings
blitzartig===blitzartig
blöderweise===blöderweise
blödsinnigerweise===blödsinnigerweise
bloß===bloß
bös===bös;böser;bösesten
böse===böse
gross===brutto
buchstäblich===buchstäblich
bzw.===bzw.
charakteriologisch===charakteriologisch
charakteristischerweise===charakteristischerweise
circa===circa;zirka
dafür===da;dafuer
darüber===da;darüber
dazu===da;dazu
bei===dabei
dabei===dabey
dadurch===dadurch
für===dafür
dagegen===dagegen
daheim===daheim
daher===daher
dahin===dahin
dahinter===dahinter
dalli===dalli
damals===damals
mit===damit;mit
dämlicherweise===dämlicherweise
danach===danach;darnach
daneben===daneben
dann===dann
daran===daran;dran
darauf===darauf
daraufhin===daraufhin
daraus===daraus
darin===darin;darinn
darum===darum;drum
darunter===darunter
das heißt===das heißt
davon===davon
davor===davor
dazwischen===dazwischen
deinetwegen===deinetwegen
dementsprechend===dementsprechend
demgegenüber===demgegenüber
demnach===demnach
demnächst===demnächst
demütigst===demütigst
demzufolge===demzufolge
dennoch===dennoch
derart===derart
derentwegen===derentwegen
derweil===derweil
derzeit===derzeit
deshalb===deshalb
dessentwegen===dessentwegen
deswegen===deswegen
detailliert===detailliert
dicht===dicht
die Arme in die Hüften gestemmt===die Arme in die Hüften gestemmt
die Arme in die Seite gestemmt===die Arme in die Seite gestemmt
die Ecke===die Ecke
in letzter Zeit===die letzte Zeit;in letzter Zeit
die Tage===die Tage
diesbezüglich===diesbezüglich
diesmal===diesmal
doch===doch
doll===doll
dort===dort
dorthin===dorthin
drauf===drauf
outside===draußen
dreimal===dreimal
drin===drin
drinnen===drinnen
droben===droben
drüben===drüben
dummerweise===dummerweise
durch und durch===durch und durch
durchaus===durchaus
durchgehend===durchgehend
durchweg===durchweg
ebenda===ebd.;ebenda
ebendort===ebd.;ebendort
ebda.===ebda.
dieser===eben;hier
ebenfalls===ebenfalls
ebenso===ebenso
echt===echt
egal===egal
eh===eh
ehemals===ehemals
eher===eher
ehrlicherweise===ehrlicherweise
eifrig===eifrig
eigenartigerweise===eigenartigerweise
eigens===eigens
eigentlich===eigentlich
eindeutig===eindeutig
einerlei===einerlei
einerseits===einerseits;zwar
eines Tages===eines Tages
einesteils===einesteils;einestheils
einfach===einfach
einfach so===einfach so
einfältigerweise===einfältigerweise
einigermaßen===einigermaßen
einmal===einmal;mal
eins===eins
einschließlich===einschließlich
einst===einst
einstens===einstens
einstweilen===einstweilen
einvernehmlich===einvernehmlich
einzeln===einzeln
einzig===einzig
einzigartig===einzigartig
elektrolytisch===elektrolytisch
empor===empor
en gros===en gros
en masse===en masse
endlich===endlich
endoskopisch===endoskopisch
endotracheal===endotracheal
energetisch===energetisch
entgegen===entgegen
entsetzlich===entsetzlich
entsprechend===entsprechend
erbarmungslos===erbarmungslos
erfahrungsgemäß===erfahrungsgemäß
erfreulicherweise===erfreulicherweise
ergo===ergo
erheblich===erheblich
erneut===erneut
erotisch===erotisch
erregt===erregt
erst===erst
erst recht===erst recht
erstaunlicherweise===erstaunlicherweise
erstens===erstens
erstmal===erstmal
erstmalig===erstmalig
erstmals===erstmals
erwartungsgemäß===erwartungsgemäß
essentiell===essentiell
essenziell===essenziell
etc. pp.===etc. pp.
etwa===etwa
etwas===etwas
euretwegen===euretwegen
eventuell===eventuell
ever===ever
ewig===ewig
ex nunc===ex nunc
ex tunc===ex tunc
explosionsartig===explosionsartig
extra===extra
extrem===extrem
fachlich===fachlich
fallweise===fallweise
fälschlicherweise===fälschlicherweise
fassungslos===fassungslos
fast===fast
ferner===ferner
fert===fert
figürlich===figürlich
fleißig===fleißig
flugs===flugs
flussabwärts===flussabwärts
flussaufwärts===flussaufwärts
folgendermaßen===folgendermaßen
folgerichtig===folgerichtig
folglich===folglich
förmlich===förmlich
fort===fort
fortan===fortan
freilich===freilich
freudig===freudig
freundlicherweise===freundlicherweise
frohgemut===frohgemut
frühestens===frühestens
frühmorgens===frühmorgens
für immer===für immer
fürbass===fürbaß
furchtbar===furchtbar
fürchterlich===fürchterlich
furchtsam===furchtsam
fürder===fürder
fürderhin===fürderhin
füreinander===füreinander
fürwahr===fürwahr
gang und gäbe===gang und gäbe
ganz===ganz
gänzlich===gänzlich
gar===gar
gar nicht===gar nicht
gefälligst===gefälligst
gegebenenfalls===gegebenenfalls
gegeneinander===gegeneinander
gegengleich===gegengleich
gehörig===gehörig
gekonnt===gekonnt
gelegentlich===gelegentlich
gell===gell
gemeinhin===gemeinhin
gemeinsam===gemeinsam
genau===genau
genauso===genauso
genauso gut===genauso gut;genausogut
genug===genug
genuin===genuin
geografisch===geografisch
geradeaus===geradeaus
geradezu===geradezu
geräuschlos===geräuschlos
geringfügig===geringfügig
gern===gern;gerne;lieber;liebsten
geschickt===geschickt
gesondert===gesondert
gestern===gestern
getrennt===getrennt
gewandt===gewandt
gewiss===gewiss
gewissermaßen===gewissermaßen
gewöhnlich===gewöhnlich
gewöhnlicherweise===gewöhnlicherweise
gewohntermaßen===gewohntermaßen
giftig===giftig
gleich===gleich
gleichermaßen===gleichermaßen
gleichfalls===gleichfalls
gleichsam===gleichsam
gleichwohl===gleichwohl
gleichzeitig===gleichzeitig
glücklicherweise===glücklicherweise
Gott sei Dank===Gott sei Dank
gratis===gratis
grauenhaft===grauenhaft
grauenvoll===grauenvoll
grausam===grausam
grausig===grausig
großtechnisch===großtechnisch
größtenteils===größtenteils
großzügig===großzügig
grundsätzlich===grundsätzlich
gruppenweise===gruppenweise
guter Hoffnung===guter Hoffnung
halb===halb
halbwegs===halbwegs
halt===halt
Hand in Hand===Hand in Hand
häppchenweise===häppchenweise
harsch===harsch
haufenweise===haufenweise
häufig===häufig
hauptsächlich===hauptsächlich
heimtückisch===heimtückisch
heint===heinacht;heint
her===her
herab===herab
heran===heran
heraus===heraus
herbei===herbei
herein===herein
herüber===herüber
herum===herum
herunter===herunter
heteronom===heteronom
heuer===heuer
heute===heut;heute;von heute auf morgen
heutzutage===heutzutage
hier===hie
hier und da===hie und da;hier und da
hienieden===hienieden;hiernieden
hieran===hieran
hierauf===hierauf
hieraus===hieraus
hierbei===hierbei
hierdurch===hierdurch
hierein===hierein
hierfür===hierfür
hiergegen===hiergegen
hierher===hierher
hierherum===hierherum
hierhin===hierhin
hierin===hierin
hiermit===hiermit
hiernach===hiernach
hiernächst===hiernächst;hiernechst
hiervon===hiervon
hierzu===hierzu
hierzulande===hierzulande
hilflos===hilflos
himmelan===himmelan
hin===hin
hin und her===hin und her
hin und wieder===hin und wieder
hinab===hinab
hinauf===hinauf
hinaus===hinaus
hindurch===hindurch
hinein===hinein
hingegen===hingegen
hinreichend===hinreichend
hinten===hinten
hintendrein===hintendrein
hintereinander===hintereinander
hinterfotzig===hinterfotzig
hinterher===hinterher
hinüber===hinüber
hinunter===hinunter
hinweg===hinweg
hinzu===hinzu
hochkant===hochkant
höchstens===höchstens
höchstpersönlich===höchstpersönlich
hoffentlich===hoffentlich
höllisch===höllisch
hordenweise===hordenweise
hüben===hüben
huckepack===huckepack
hundertmal===hundertmal
idealerweise===idealerweise
ihrerseits===ihrerseits
ihretwegen===ihretwegen
im Gegenzug===im Gegenzug
im großen Stil===im großen Stil
im Großen und Ganzen===im Großen und Ganzen
im Guten===im Guten
im Herzen===im Herzen
im Moment===im Moment
im Nachhinein===im Nachhinein
im Nu===im Nu
im Schnitt===im Schnitt
im selben Atemzug===im selben Atemzug
im übertragenen Sinne===im übertragenen Sinne
im Voraus===im Voraus
immer noch===immer noch
immer wieder===immer wieder
immer===immer;mehr
immerhin===immerhin
in aller Frühe===in aller Frühe
in der Regel===in der Regel
in der Tat===in der Tat
in echt===in echt
in einem fort===in einem fort
in erster Linie===in erster Linie
in etwa===in etwa
in gewisser Weise===in gewisser Weise
in höchstem Maße===in höchstem Maße
in petto===in petto
in Wirklichkeit===in Wirklichkeit
in Zukunft===in Zukunft
inbrünstig===inbrünstig
indessen===indessen
indirekt===indirekt
induktiv===induktiv
ineinander===ineinander
informell===informell
inklusive===inklusive
innen===innen
innerhalb===innerhalb
ins Detail gehend===ins Detail gehend
ins Einzelne gehend===ins Einzelne gehend
insbesondere===insbesondere;insbesondre
insgeheim===insgeheim
insgesamt===insgesamt
insofern===insofern
instrumentell===instrumentell
intelligenterweise===intelligenterweise
interessanterweise===interessanterweise
inwiefern===inwiefern
inwieweit===inwieweit
inzwischen===inzwischen
irgend===irgend
irgendwann===irgendwann
irgendwie===irgendwie
irgendwo===irgendwo
irgendwohin===irgendwohin
irrsinnigerweise===irrsinnigerweise
irrtümlicherweise===irrtümlicherweise
ja===ja
jahrelang===jahrelang
jährlich===jährlich
je===je
je nachdem===je nachdem
jedenfalls===jedenfalls
jederzeit===jederzeit
jedes Mal===jedesmal
jedoch===jedoch
jeher===jeher
jein===jein
jemals===jemals
jeweilig===jeweilig
jeweils===jeweils
jüngst===jüngst
just===just
justament===justament
kaum===kaum
kein Jota===kein Jota
keinesfalls===keinesfalls
keineswegs===keineswegs
keinmal===keinmal
klinisch===klinisch
klugerweise===klugerweise
knapp===knapp
komischerweise===komischerweise
kompromisslos===kompromisslos
konkret===konkret
kontinental===kontinental
kostenlos===kostenlos
kreuz und quer===kreuz und quer
kreuzweise===kreuzweise
kriegsbedingt===kriegsbedingt
künftig===künftig
kurz===kurz
kurz ab===kurz ab
kurzerhand===kurzerhand
kürzlich===kürzlich
links===l.;li.;links
lange===lang;lange;mehr
langsam===langsam
laufend===laufend
lauter===lauter
lauthals===lauthals
lecker===lecker
lediglich===lediglich
leicht===leicht
leichtsinnigerweise===leichtsinnigerweise
leidenschaftslos===leidenschaftslos
leider===leider
leihweise===leihweise
letztendlich===letztendlich
letztens===letztens
letztlich===letztlich
leuchtend===leuchtend
live===live
löffelweise===löffelweise
logisch===logisch
logo===logo
los===los
lustigerweise===lustigerweise
lustvoll===lustvoll
luvwärts===luvwärts
hätten===mal
wohl===mal;wol;woll
man===man
mancherorts===mancherorts
manchmal===manchmal
maßlos===maßlos
mechanisch===mechanisch
Kind===mehr
nichts===mehr
viel===mehr;meisten;viel
nicht===mehr;net;nich;nicht
nie===mehr;nie
mehrheitlich===mehrheitlich
mehrmals===mehrmals
meinetwegen===meinetwegen
meist===meist
meistens===meistens
mengenmäßig===mengenmäßig
merkwürdigerweise===merkwürdigerweise
mindestens===mindestens
ministeriell===ministeriell
minus===minus
mir nichts, dir nichts===mir nichts, dir nichts
missbräuchlicherweise===missbräuchlicherweise
mit Abstand===mit Abstand
mit anderen Worten===mit anderen Worten
mit angehaltenem Atem===mit angehaltenem Atem
mit einem Mal===mit einem Mal;mit einemmal
mit Fug und Recht===mit Fug und Recht
mit halbem Herzen===mit halbem Herzen
mit Herz===mit Herz
mit Kind und Kegel===mit Kind und Kegel
mit Mann und Maus===mit Mann und Maus
mit Sack und Pack===mit Sack und Pack
mit vollen Zügen===mit vollen Zügen
miteinander===miteinander
mithin===mithin
mitnichten===mitnichten
mittags===mittags
mitten===mitten
mittendrin===mittendrin
mitternachts===mitternachts
mittlerweile===mittlerweile
mitunter===mitunter
möglicherweise===möglicherweise
möglichst===möglichst
momentan===momentan
monatelang===monatelang
morgens===morgens
morgen===morgn;von heute auf morgen
mühselig===mühselig
mütterlicherseits===mütterlicherseits
nach===nach
nach Hause===nach Hause;nachhause
nach oben===nach oben
nach und nach===nach und nach
nach wie vor===nach wie vor
nachdrücklichst===nachdrücklichst
nacheinander===nacheinander
nachgerade===nachgerade
nachher===nachher
nachmittags===nachmittags
nachträglich===nachträglich
nachts===nachts
nah===nah
näherungsweise===näherungsweise
nahezu===nahezu
naiverweise===naiverweise
namens===namens
namentlich===namentlich
nämlich===nämlich
natürlich===natürlich
natürlicherweise===natürlicherweise
nebenan===nebenan
nebenbei===nebenbei
nebeneinander===nebeneinander
nennenswert===nennenswert
neuerdings===neuerdings
neuerlich===neuerlich
neugierig===neugierig
neulich===neulich;neuwlich
nicht einmal===nicht einmal
nichtsdestotrotz===nichtsdestotrotz
nichtsdestoweniger===nichtsdestoweniger
nieder===nieder
niemals===niemals
nimmer===nimmer
nimmermehr===nimmermehr
nirgends===nirgends
nirgendwo===nirgendwo
nirgendwohin===nirgendwohin
additional===noch
another===noch
more===noch
nor===noch
weder===noch
yet===noch
noch dazu===noch dazu
noch einmal===noch einmal
still===noch;still
nochall===nochall
nochmal===nochmal
nochmals===nochmals
nomma===nomma
nordwärts===nordwärts
nordwestlich===nordwestlich
normalerweise===normalerweise
nötig===nötig
notwendigerweise===notwendigerweise
nun===nu;nun
nunmehr===nunmehr
nur===nur
nur über meine Leiche===nur über meine Leiche
nurmehr===nurmehr
o. B. d. A.===o. B. d. A.
oben===oben
obenauf===obenauf
obendrein===obendrein
offenbar===offenbar
offensichtlich===offensichtlich
oft===oft;öfter;öftesten
öfters===öfters
oftmals===oftmals
ohne===ohne
ohne Schnickschnack===ohne Schnickschnack
ohne Unterlass===ohne Unterlass
ohnedies===ohnedies
ohnegleichen===ohnegleichen
ohnehin===ohnehin
okay===okay
ökologisch===öko;ökologisch
optisch===optisch
ordnungsgemäß===ordnungsgemäß
ordnungsmäßig===ordnungsmäßig
ostwärts===ostwärts
oxidativ===oxidativ
paarmal===paarmal
paradoxerweise===paradoxerweise
partout===partout
pauschal===pauschal
permanent===permanent
persönlich===persönlich
peu à peu===peu à peu
plötzlich===plötzlich
plus===plus
portionsweise===portionsweise
potenziell===potentiell;potenziell
praktisch===praktisch
prinzipiell===prinzipiell
pro Kopf===pro Kopf
programmatisch===programmatisch
quasi===quasi
quer===quer
radikalisch===radikalisch
ran===ran
rasch===rasch
rauf===rauf
raus===raus
recht===recht
rechts===rechts
rechtshin===rechtshin
rechtzeitig===rechtzeitig
regulär===regulär
reihenweise===reihenweise
rein===rein
restlos===restlos
retour===retour
rheinabwärts===rheinabwärts
rheinaufwärts===rheinaufwärts
richtigerweise===richtigerweise
rigoros===rigoros
ringsum===ringsum
rittlings===rittlings
rüber===rüber
rückgängig machbar===rückgängig machbar
rückwärts===rückwärts
ruhig===ruhig
rund===rund
rund um die Uhr===rund um die Uhr
rundum===rundum
rundweg===rundweg
runter===runter
rustikal===rustikal
sacht===sacht;sachte
samt und sonders===samt und sonders
scharenweise===scharenweise
schätzungsweise===schätzungsweise
creepily===schaurig
eerily===schaurig
ghoulishly===schaurig
scheibchenweise===scheibchenweise
scheinbar===scheinbar
schichtweise===schichtweise
schier===schier
schlaftrunken===schlaftrunken
schlagartig===schlagartig
schlauerweise===schlauerweise
schlechterdings===schlechterdings
schlechthin===schlechthin
schleunigst===schleunigst
schließlich===schließlich
schlussendlich===schlussendlich
schnell===schnell
schnurstracks===schnurstracks
schon mal===schomma;schon mal;schonmal
schön===schön
schrecklich===schrecklich
schrittweise===schrittweise
sehnsüchtig===sehnsüchtig
sehr===sehr
seinerseits===seinerseits
seinerzeit===seinerzeit
seinetwegen===seinetwegen
seitdem===seitdem
seither===seither
seitlich===seitlich
selbst===selbst
selbstverständlich===selbstverständlich
selten===selten
seltsamerweise===seltsamerweise
semantisch===semantisch
sexuell===sexuell
sicher===sicher
sicherheitshalber===sicherheitshalber
sicherlich===sicherlich
sichtlich===sichtlich
sinnbildhaft===sinnbildhaft
sinnbildlich===sinnbildlich
sinnvollerweise===sinnvollerweise
so bald wie möglich===so bald wie möglich
wie===so;wie
soeben===soeben
sofort===sofort
sogar===sogar
sogleich===sogleich
solange===solange
solcherart===solcherart
solchermaßen===solchermaßen
solidarisch===solidarisch
somit===somit
sonders===sonders
sonst===sonst
sorglich===sorglich
soviel===soviel
sowieso===sowieso
sozusagen===sozusagen
sparsam===sparsam
spätabends===spätabends
später===später
späterhin===späterhin
spätestens===spätestens
spätnachts===spätnachts
spektroskopisch===spektroskopisch
sporadisch===sporadisch
ständig===ständig
stapelweise===stapelweise
stattdessen===stattdessen
steckbrieflich===steckbrieflich
stehenden Fußes===stehenden Fußes
stets===stets
stiekum===stiekum
stöchiometrisch===stöchiometrisch
strafrechtlich===strafrechtlich
strahlend===strahlend
strategisch===strategisch
streng===streng
strukturell===strukturell
Stück für Stück===Stück für Stück
stückchenweise===stückchenweise
stückweise===stückweise
stufenweise===stufenweise
stundenlang===stundenlang
südwärts===südwärts
sukzessive===sukzessive
summa summarum===summa summarum
symbolisch===symbolisch
systematisch===systematisch
szintigrafisch===szintigrafisch;szintigraphisch
Tag und Nacht===Tag und Nacht
tagelang===tagelang
tagsüber===tagsüber
talwärts===talwärts
tatsächlich===tatsächlich
teilweise===teilweise
themseaufwärts===themseaufwärts
tiefgreifend===tiefgreifend
tollkühn===tollkühn
traurig===traurig
traurigerweise===traurigerweise
tropfenweise===tropfenweise
trotzdem===trotzdem
tunlichst===tunlichst
turnusgemäß===turnusgemäß
typischerweise===typischerweise
typografisch===typografisch;typographisch
über alles===über alles
über die Dörfer===über die Dörfer
über Gebühr===über Gebühr
über===über;ueber
alles===überall
überaus===überaus
überdies===überdies
übereinander===übereinander
überflüssig===überflüssig
überhaupt===überhaupt
überhaupt nicht===überhaupt nicht
übermorgen===übermorgen
überraschend===überraschend
überraschenderweise===überraschenderweise
überwiegend===überwiegend
üblicherweise===üblicherweise
übrigens===übrigens
um===um
um Himmels willen===um Himmels willen
umgehend===umgehend
umgekehrt===umgekehrt
umher===umher
umsonst===umsonst
unablässig===unablässig
unabsehbar===unabsehbar
unangenehm===unangenehm
unauffällig===unauffällig
unbedingt===unbedingt
unbeholfen===unbeholfen
und so weiter===und so weiter
und zwar===und zwar;zwar
und, und, und===und, und, und
unecht===unecht
unermüdlich===unermüdlich
unfreundlicherweise===unfreundlicherweise
ungeduldig===ungeduldig
ungefähr===ungefähr
ungehalten===ungehalten
ungeheuer===ungeheuer
ungerechtfertigterweise===ungerechtfertigterweise
ungewöhnlich===ungewöhnlich
ungewöhnlicherweise===ungewöhnlicherweise
ungleich===ungleich
unglücklich===unglücklich
unglücklicherweise===unglücklicherweise
unhöflicherweise===unhöflicherweise
unlängst===unlängst
unnötigerweise===unnötigerweise
unrealistischerweise===unrealistischerweise
unruhig===unruhig
unseretwegen===unseretwegen;unsretwegen
unsinnig===unsinnig
unsinnigerweise===unsinnigerweise
unstet===unstet
unten===unten
unter anderem===unter anderem
unter der Woche===unter der Woche
unterdessen===unterdessen
untereinander===untereinander
unterwegs===unterwegs
untypischerweise===untypischerweise
unüberlegt===unüberlegt
unverfroren===unverfroren
unversehens===unversehens
unverständlicherweise===unverständlicherweise
unverzüglich===unverzüglich
unwillkürlich===unwillkürlich
unzulässig===unzulässig
unzulässigerweise===unzulässigerweise
ursprünglich===ursprünglich
väterlicherseits===väterlicherseits
verachtend===verachtend
verächtlich===verächtlich
verbittert===verbittert
verflixt===verflixt
in vain===vergebens
vergleichsweise===vergleichsweise
verhältnismäßig===verhältnismäßig
vermutlich===vermutlich
vernachlässigbar===vernachlässigbar
vernünftigerweise===vernünftigerweise
verschiedentlich===verschiedentlich
versehentlich===versehentlich
verso===verso
verständlicherweise===verständlicherweise
versuchsweise===versuchsweise
vertraglich===vertraglich
verzweifelt===verzweifelt
vielerorts===vielerorts
vielmals===vielmals
vielmehr===vielmehr
viermal===viermal
voll===voll
volle Möhre===volle Möhre
vollends===vollends
voller===voller
vollständig===vollständig
von A bis Z===von A bis Z
von da an===von da an
von ganzem Herzen===von ganzem Herzen
von Herzen===von Herzen
von===von heute auf morgen
von selbst===von selbst
von vornherein===von vornherein
voneinander===voneinander
vor allem===vor allem
vor Ort===vor Ort
vorab===vorab
voran===voran
voraussichtlich===voraussichtlich
vorerst===vorerst
vorgeblich===vorgeblich
vorgestern===vorgestern
vorher===vorher;vorhero
vorhin===vorhin
vormals===vormals
vorn===vorn
vorne===vorne
vornehmlich===vornehmlich
vorschriftsmäßig===vorschriftsmäßig
vorsichtig===vorsichtig
vorsichtshalber===vorsichtshalber
vorsorglich===vorsorglich
vortrefflich===vortrefflich
vorüber===vorüber
vorwärts===vorwärts
vorwiegend===vorwiegend
vorzeitig===vorzeitig
vorzugsweise===vorzugsweise
wa===wa
wahnsinnig===wahnsinnig
wahrhaftig===wahrhaftig
wahrlich===wahrlich
wahrscheinlich===wahrscheinlich
wann===wann
wann anders===wann anders
warum===warum
was===was
was auch passiert===was auch passiert
was für===was für
weg===weg
weiland===weiland
weise===weis
weit===weit
weitaus===weitaus
weiterhin===weiterhin
weitgehend===weitgehend
weithin===weithin
weniger===weniger
wenigstens===wenigstens
wenn Ostern und Pfingsten auf einen Tag fallen===wenn Ostern und Pfingsten auf einen Tag fallen
weshalb===weshalb
wessentwegen===wessentwegen
westwärts===westwärts
weswegen===weswegen
widerlich===widerlich
widerwillig===widerwillig
wie der Teufel das Weihwasser===wie der Teufel das Weihwasser
wie viel===wie viel;wieviel
wieder===wieder
wiederholt===wiederholt
wiederum===wiederum;wiederumb
wieso===wieso
willentlich===willentlich
windwärts===windwärts
wirklich===wirklich
witzigerweise===witzigerweise
wo===wo
woanders===woanders
wobei===wobei
wochenlang===wochenlang
wodurch===wodurch
wofür===wofür
wogegen===wogegen
woher===woher
wohin===wohin
wohinter===wohinter
do===wohl
must===wohl
womit===womit
womöglich===womöglich
wonach===wonach
woneben===woneben
woran===woran
worauf===worauf
woraufhin===woraufhin
woraus===woraus
worin===worin
wörtlich===wörtlich
worüber===worüber
worum===worum
worunter===worunter
wovon===wovon
wovor===wovor
wozu===wozu
wozwischen===wozwischen
wütend===wütend
zum Teil===z. T.;zum Teil
zehnmal===zehnmal
zeitgleich===zeitgleich
zeitlebens===zeitlebens
zeitweise===zeitweise
zentral===zentral
zickzack===zickzack
ziemlich===ziemlich
zigmal===zigmal
zottelig===zottelig
zu===zu
zu dritt===zu dritt
zu Fuß===zu Fuß
zu Hause===zu Hause;zuhause
zu Herzen===zu Herzen
zu viel===zu viel;zuviel
zu viert===zu viert
zu zweit===zu zweit
zudem===zudem
zueinander===zueinander
zuerst===zuerst
zufällig===zufällig
zufälligerweise===zufälligerweise
zugegebenermaßen===zugegebenermaßen
zugleich===zugleich
zukünftig===zukünftig
zuletzt===zuletzt
zum Glück===zum Glück
zumal===zumal
zumeist===zumeist
zumindest===zumindest
zumindestens===zumindestens
zunächst===zunächst
zunutze===zunutze
zur Abwechslung===zur Abwechslung
zur Genüge===zur Genüge
zur Zeit===zur Zeit
zurück===zurück
zurzeit===zurzeit;zz.;zzt.
zusammen===zusammen
zusehends===zusehends
zutage===zutage
zutiefst===zutiefst
zuverlässig===zuverlässig
zuvor===zuvor
zuweilen===zuweilen
zuwenig===zuwenig
zweckmäßigerweise===zweckmäßigerweise
zweierlei===zweierlei
zweifach===zweifach
zweifellos===zweifellos
zweifelsohne===zweifelsohne
zweimal===zweimal
zweitens===zweitens
zwischenzeitlich===zwischenzeitlich
zylindrisch===zylindrisch
ꝛc.===ꝛc.