großteils===großteils;
damit===damit;
zugegebenermaßen===zugegebenermaßen;
systematisch===systematisch;
mitternachts===mitternachts;
gegebenenfalls===gegebenenfalls;
grundsätzlich===grundsätzlich;
typischerweise===typischerweise;
zumal===zumal;
späterhin===späterhin;
manchmal===manchmal;
streng===streng;
näherungsweise===näherungsweise;
aber===aber;
irgendwo===irgendwo;
vorschriftsmäßig===vorschriftsmäßig;
dafür===dafür;
morgens===morgens;
auseinander===auseinander;
beinah===beinah;
mütterlicherseits===mütterlicherseits;
keinmal===keinmal;
auswendig===auswendig;
gekonnt===gekonnt;
insbesondere===insbesondere;
klinisch===klinisch;
neulich===neulich;
dementsprechend===dementsprechend;
unlängst===unlängst;
fert===fert;
rauf===rauf;
äußerst===äußerst;
hinüber===hinüber;
einerseits===einerseits;
deshalb===deshalb;
geografisch===geografisch;
fortan===fortan;
gefälligst===gefälligst;
selbst===selbst;
ineinander===ineinander;
hinweg===hinweg;
jährlich===jährlich;
voraus===voraus;
scheibchenweise===scheibchenweise;
anders===anders;
gewissermaßen===gewissermaßen;
mithin===mithin;
kreuzweise===kreuzweise;
praktisch===praktisch;
sogar===sogar;
nieder===nieder;
buchstäblich===buchstäblich;
gleichermaßen===gleichermaßen;
droben===droben;
gleichsam===gleichsam;
immer===immer;
wozu===wozu;
überaus===überaus;
abhanden===abhanden;
sonders===sonders;
apropos===apropos;
später===später;
nimmer===nimmer;
drin===drin;
ungefähr===ungefähr;
dazu===dazu;
zirka===zirka;
blindlings===blindlings;
einesteils===einesteils;
einzeln===einzeln;
mal===mal;
abends===abends;
kurz===kurz;
seitlich===seitlich;
allzu===allzu;
fürwahr===fürwahr;
monatelang===monatelang;
wovon===wovon;
hinein===hinein;
wofür===wofür;
weg===weg;
erst===erst;
sicher===sicher;
geringfügig===geringfügig;
hüben===hüben;
feige===feige;
energetisch===energetisch;
achtmal===achtmal;
eh===eh;
tiefgreifend===tiefgreifend;
durchaus===durchaus;
draußen===draußen;
unterwegs===unterwegs;
eben===eben;
womit===womit;
woraufhin===woraufhin;
gleich===gleich;
explosionsartig===explosionsartig;
wobei===wobei;
etwa===etwa;
abweichend===abweichend;
woanders===woanders;
optisch===optisch;
anatomisch===anatomisch;
wozwischen===wozwischen;
blitzartig===blitzartig;
hierfür===hierfür;
doch===doch;
zweiwöchentlich===zweiwöchentlich;
unverzüglich===unverzüglich;
niemals===niemals;
hinten===hinten;
ungeduldig===ungeduldig;
jein===jein;
verhältnismäßig===verhältnismäßig;
samt===samt;
mitnichten===mitnichten;
da===da;
kaum===kaum;
letztlich===letztlich;
morgen===morgen;
potenziell===potenziell;potentiell;
justament===justament;
nochmals===nochmals;
ausgeschrieben===ausgeschrieben;
arithmetisch===arithmetisch;
zutiefst===zutiefst;
warum===warum;
eins===eins;
leichtsinnigerweise===leichtsinnigerweise;
folgendermaßen===folgendermaßen;
zunutze===zunutze;
abermals===abermals;
übrigens===übrigens;
jedoch===jedoch;
leidenschaftslos===leidenschaftslos;
höchstens===höchstens;
allerdings===allerdings;
fast===fast;
meist===meist;
ökologisch===ökologisch;
außen===außen;
darüber===darüber;
grad===grad;
rückwärts===rückwärts;
sehnsüchtig===sehnsüchtig;
retour===retour;
schriftlich===schriftlich;
mehr===mehr;
inzwischen===inzwischen;
nah===nah;
darunter===darunter;
rechtshin===rechtshin;
ebenso===ebenso;
vortrefflich===vortrefflich;
wochenlang===wochenlang;
vielerorts===vielerorts;
namentlich===namentlich;
alsdenn===alsdenn;
gestern===gestern;
hierher===hierher;
vermutlich===vermutlich;
Hacke===Hacke;
sowieso===sowieso;
zeitweise===zeitweise;
empor===empor;
wie===wie;
ebda.===ebda.;
kürzlich===kürzlich;
neuerlich===neuerlich;
darauf===darauf;
still===still;
dabei===dabei;
oft===oft;
herbei===herbei;
andersrum===andersrum;
genuin===genuin;
ran===ran;
ministeriell===ministeriell;
gesondert===gesondert;
gell===gell;
an===an;
zweifach===zweifach;
insgeheim===insgeheim;
daraus===daraus;
laufend===laufend;
willentlich===willentlich;
beizeiten===beizeiten;
zwar===zwar;
augenscheinlich===augenscheinlich;
einstweilen===einstweilen;
äußerlich===äußerlich;
zweitens===zweitens;
zurück===zurück;
widerwillig===widerwillig;
schliesslich===schliesslich;
zusammen===zusammen;
jüngst===jüngst;
voraussichtlich===voraussichtlich;
ferner===ferner;
ackerbaulich===ackerbaulich;
zwischenzeitlich===zwischenzeitlich;
her===her;
lediglich===lediglich;
frühmorgens===frühmorgens;
worum===worum;
weiterhin===weiterhin;
einfach===einfach;
endlich===endlich;
gleichfalls===gleichfalls;
hinaus===hinaus;
absolut===absolut;
bergab===bergab;
glücklicherweise===glücklicherweise;
hingegen===hingegen;
gewöhnlich===gewöhnlich;
gar===gar;
versehentlich===versehentlich;
rüber===rüber;
zeitgleich===zeitgleich;
überall===überall;
partout===partout;
erfahrungsgemäß===erfahrungsgemäß;
bar===bar;
gratis===gratis;
luvwärts===luvwärts;
strafrechtlich===strafrechtlich;
elektrolytisch===elektrolytisch;
jemals===jemals;
folgerichtig===folgerichtig;
irgendwann===irgendwann;
beinahe===beinahe;
wohl===wohl;
zueinander===zueinander;
strukturell===strukturell;
vorwiegend===vorwiegend;
entgegen===entgegen;
unnötigerweise===unnötigerweise;
gemeinsam===gemeinsam;
hierin===hierin;
allzuviel===allzuviel;
zukünftig===zukünftig;
wahnsinnig===wahnsinnig;
anderswo===anderswo;
ordnungsgemäß===ordnungsgemäß;
vorhin===vorhin;
darum===darum;
vormittags===vormittags;
erheblich===erheblich;
ehemals===ehemals;
bloss===bloss;
möglicherweise===möglicherweise;
nacheinander===nacheinander;
flussaufwärts===flussaufwärts;
ziemlich===ziemlich;
sicherheitshalber===sicherheitshalber;
Amen===Amen;
links===links;
nebenbei===nebenbei;
regulär===regulär;
drüben===drüben;
aneinander===aneinander;
jeweils===jeweils;
gehörig===gehörig;
tagsüber===tagsüber;
notwendigerweise===notwendigerweise;
allmählich===allmählich;allmählig;
voller===voller;
wohin===wohin;
genau===genau;
jeweilig===jeweilig;
geradezu===geradezu;
hierhin===hierhin;
'n==='n;
schon===schon;
runter===runter;
dazwischen===dazwischen;
bisher===bisher;
etwas===etwas;
sinnbildhaft===sinnbildhaft;
hin===hin;
nein===nein;
umsonst===umsonst;
stundenlang===stundenlang;
nirgends===nirgends;
einzigartig===einzigartig;
hoffentlich===hoffentlich;
ueber===ueber;
extrem===extrem;
live===live;
rittlings===rittlings;
mancherorts===mancherorts;
meistens===meistens;
bedauerlicherweise===bedauerlicherweise;
gern===gern;
stets===stets;
zuviel===zuviel;
offenbar===offenbar;
mühselig===mühselig;
hinunter===hinunter;
unten===unten;
rigoros===rigoros;
drinnen===drinnen;
bloß===bloß;
konkret===konkret;
permanent===permanent;
einvernehmlich===einvernehmlich;
allein===allein;alleine;
außerordentlich===außerordentlich;
dafuer===dafuer;
recht===recht;
zweimal===zweimal;
meinetwegen===meinetwegen;
zweierlei===zweierlei;
insgesamt===insgesamt;
zickzack===zickzack;
worauf===worauf;
viermal===viermal;
was===was;
jetzt===jetzt;
sofort===sofort;
ausschließlich===ausschließlich;
deswegen===deswegen;
voran===voran;
drum===drum;
dorthin===dorthin;
informell===informell;
heute===heute;
wonach===wonach;
besonders===besonders;
ohnedies===ohnedies;
ergo===ergo;
oftmals===oftmals;
mengenmäßig===mengenmäßig;
väterlicherseits===väterlicherseits;
sexuell===sexuell;
zuvor===zuvor;
persönlich===persönlich;
selbstverständlich===selbstverständlich;
nebenan===nebenan;
gelegentlich===gelegentlich;
mittendrin===mittendrin;
indirekt===indirekt;
zunächst===zunächst;
solange===solange;
je===je;
bestenfalls===bestenfalls;
vorzugsweise===vorzugsweise;
entsprechend===entsprechend;
woher===woher;
irgendwie===irgendwie;
ungewöhnlich===ungewöhnlich;
dadurch===dadurch;
langsam===langsam;
also===also;
ja===ja;
radikalisch===radikalisch;
vorüber===vorüber;
sinnbildlich===sinnbildlich;
freilich===freilich;
dicht===dicht;
stattdessen===stattdessen;
spätabends===spätabends;
jederzeit===jederzeit;
etc.===etc.;
höchstpersönlich===höchstpersönlich;
rund===rund;
mechanisch===mechanisch;
ansonsten===ansonsten;
behelfsweise===behelfsweise;
nachmittags===nachmittags;
wie viel===wie viel;wieviel;
häufig===häufig;
drauf===drauf;
zufällig===zufällig;
erwartungsgemäß===erwartungsgemäß;
zuerst===zuerst;
versuchsweise===versuchsweise;
teilweise===teilweise;
wo===wo;
talwärts===talwärts;
nebeneinander===nebeneinander;
einstens===einstens;
instrumentell===instrumentell;
charakteriologisch===charakteriologisch;
womöglich===womöglich;
schlussendlich===schlussendlich;
vorwärts===vorwärts;
los===los;
vornehmlich===vornehmlich;
größtenteils===größtenteils;
hier===hier;
danach===danach;darnach;
wurst===wurst;
flugs===flugs;
zweifelsohne===zweifelsohne;
füreinander===füreinander;
nurmehr===nurmehr;
jedenfalls===jedenfalls;
unstet===unstet;
nachher===nachher;
wiederum===wiederum;
reihenweise===reihenweise;
oben===oben;
nochall===nochall;
schlagartig===schlagartig;
bißchen===bißchen;
unglücklicherweise===unglücklicherweise;
schnurstracks===schnurstracks;
fachlich===fachlich;
genauso===genauso;
fürbaß===fürbaß;
durchgehend===durchgehend;
dreimal===dreimal;
anbei===anbei;
paradoxerweise===paradoxerweise;
essentiell===essentiell;
lustvoll===lustvoll;
demnächst===demnächst;
sonst===sonst;
herüber===herüber;
anscheinend===anscheinend;
fälschlicherweise===fälschlicherweise;
vollständig===vollständig;
um===um;
überraschenderweise===überraschenderweise;
wieder===wieder;
schließlich===schließlich;
einschließlich===einschließlich;
andererseits===andererseits;andrerseits;
herunter===herunter;
daheim===daheim;
nun===nun;
missbräuchlicherweise===missbräuchlicherweise;
dahin===dahin;
mittags===mittags;
weit===weit;
sukzessive===sukzessive;
turnusgemäß===turnusgemäß;
erstmals===erstmals;
vielmals===vielmals;
essenziell===essenziell;
ausdrücklich===ausdrücklich;
freudig===freudig;
vorn===vorn;
spektroskopisch===spektroskopisch;
normalerweise===normalerweise;
nahezu===nahezu;
nur===nur;
zentral===zentral;
seither===seither;
innen===innen;
barfuß===barfuß;
mittlerweile===mittlerweile;
tagelang===tagelang;
andernorts===andernorts;
überdies===überdies;
derart===derart;
vorsorglich===vorsorglich;
zurzeit===zurzeit;
umgehend===umgehend;
einzig===einzig;
genausogut===genausogut;
bereitwillig===bereitwillig;
herum===herum;
einst===einst;
dagegen===dagegen;
außerdem===außerdem;
soviel===soviel;
figürlich===figürlich;
bildlich===bildlich;
so===so;
weniger===weniger;
rechts===rechts;
heutzutage===heutzutage;
oxidativ===oxidativ;
öfters===öfters;
wohinter===wohinter;
verso===verso;
abstrus===abstrus;
ruhig===ruhig;
bereits===bereits;
schlechterdings===schlechterdings;
vielleicht===vielleicht;
allegorisch===allegorisch;
überwiegend===überwiegend;
augenblicklich===augenblicklich;
nämlich===nämlich;
vernachlässigbar===vernachlässigbar;
schrittweise===schrittweise;
sehr===sehr;
sicherlich===sicherlich;
stufenweise===stufenweise;
eventuell===eventuell;
heteronom===heteronom;
weitaus===weitaus;
plötzlich===plötzlich;
vorgestern===vorgestern;
folglich===folglich;
vielmehr===vielmehr;
ebenfalls===ebenfalls;
momentan===momentan;
lang===lang;
mitunter===mitunter;
überhaupt===überhaupt;
umgekehrt===umgekehrt;
hindurch===hindurch;
öfter===öfter;
worin===worin;
darin===darin;
neuerdings===neuerdings;
gewiß===gewiß;
denn===denn;
andernfalls===andernfalls;
vorgeblich===vorgeblich;
nichtsdestotrotz===nichtsdestotrotz;
spätestens===spätestens;
schlechthin===schlechthin;
dort===dort;
daneben===daneben;
symbolisch===symbolisch;
derbe===derbe;
rein===rein;
weshalb===weshalb;
soeben===soeben;
weswegen===weswegen;
hinterfotzig===hinterfotzig;
quer===quer;
lange===lange;
herab===herab;
anfangs===anfangs;
zweifellos===zweifellos;
daher===daher;
hinzu===hinzu;
worüber===worüber;
zumindest===zumindest;
bergauf===bergauf;
beispielsweise===beispielsweise;
hierdurch===hierdurch;
selten===selten;
baldmöglichst===baldmöglichst;
ordnungsmäßig===ordnungsmäßig;
halt===halt;
traurig===traurig;
ausreichend===ausreichend;
eindeutig===eindeutig;
eigentlich===eigentlich;
diesmal===diesmal;
ursprünglich===ursprünglich;
barfuss===barfuss;
dann===dann;
heimtückisch===heimtückisch;
ohnehin===ohnehin;
nennenswert===nennenswert;
übermorgen===übermorgen;
ebenda===ebenda;
ungeheuer===ungeheuer;
trotzdem===trotzdem;
unecht===unecht;
sporadisch===sporadisch;
zuletzt===zuletzt;
vorher===vorher;vorhero;
bitte===bitte;
wogegen===wogegen;
anschließend===anschließend;
abseits===abseits;
getrennt===getrennt;
gleichzeitig===gleichzeitig;
prinzipiell===prinzipiell;
kontinental===kontinental;
zusehends===zusehends;
fleißig===fleißig;
hierbei===hierbei;
zumeist===zumeist;
vorne===vorne;
gewiss===gewiss;
extra===extra;
unbedingt===unbedingt;
zufälligerweise===zufälligerweise;
schnell===schnell;
fort===fort;
obendrein===obendrein;
künftig===künftig;
bisschen===bisschen;
somit===somit;
gerne===gerne;
ohnegleichen===ohnegleichen;
andersherum===andersherum;
daran===daran;dran;
nach===nach;
induktiv===induktiv;
nordwestlich===nordwestlich;
wann===wann;
unsinnig===unsinnig;
fürbass===fürbass;
fürder===fürder;
ganz===ganz;
aufeinander===aufeinander;
solchermaßen===solchermaßen;
miteinander===miteinander;
jahrelang===jahrelang;
gänzlich===gänzlich;
nirgendwo===nirgendwo;
großtechnisch===großtechnisch;
hochkant===hochkant;
wodurch===wodurch;
auch===auch;
logo===logo;
dran===dran;
gut===gut;
bald===bald;
leider===leider;
diesbezüglich===diesbezüglich;
ständig===ständig;
wahrscheinlich===wahrscheinlich;
scheinbar===scheinbar;
quasi===quasi;
noch===noch;
mitten===mitten;
schön===schön;
tatsächlich===tatsächlich;
hinreichend===hinreichend;
szintigrafisch===szintigrafisch;szintigraphisch;
durchweg===durchweg;
nochmal===nochmal;
natürlich===natürlich;
eher===eher;
bestimmt===bestimmt;
zehnmal===zehnmal;
untereinander===untereinander;
nicht===nicht;
möglichst===möglichst;
hierzu===hierzu;
kostenlos===kostenlos;
erneut===erneut;
hiervon===hiervon;
höllisch===höllisch;
immerhin===immerhin;
notfalls===notfalls;
zweckmäßigerweise===zweckmäßigerweise;
sparsam===sparsam;
einmal===einmal;
nachts===nachts;
solidarisch===solidarisch;
demnach===demnach;
dennoch===dennoch;
logisch===logisch;
typografisch===typografisch;typographisch;
hiermit===hiermit;
förmlich===förmlich;
wörtlich===wörtlich;
weitgehend===weitgehend;
längst===längst;
vergebens===vergebens;
woran===woran;
erotisch===erotisch;
weithin===weithin;
heuer===heuer;
vergleichsweise===vergleichsweise;
worunter===worunter;
vorzeitig===vorzeitig;
frühestens===frühestens;
ewig===ewig;
beziehungsweise===beziehungsweise;
verschiedentlich===verschiedentlich;
woneben===woneben;
mindestens===mindestens;
ledig===ledig;
irgendwohin===irgendwohin;
zudem===zudem;
stöchiometrisch===stöchiometrisch;
zuhause===zuhause;
zu===zu;
nichtsdestoweniger===nichtsdestoweniger;
eigenartigerweise===eigenartigerweise;
erstmalig===erstmalig;
bislang===bislang;
vorerst===vorerst;
kompromisslos===kompromisslos;
weiland===weiland;
geradeaus===geradeaus;
hauptsächlich===hauptsächlich;
dahinter===dahinter;
nie===nie;
genug===genug;
allenfalls===allenfalls;
vorsichtshalber===vorsichtshalber;
gemeinhin===gemeinhin;
wenigstens===wenigstens;
zugleich===zugleich;
hieraus===hieraus;
flussabwärts===flussabwärts;
letztendlich===letztendlich;
aus===aus;
mehrmals===mehrmals;
irrtümlicherweise===irrtümlicherweise;
wieso===wieso;
einestheils===einestheils;
nachhause===nachhause;
spätnachts===spätnachts;
rechtzeitig===rechtzeitig;
insofern===insofern;
