euer===euer;
jener===jener;jene;jenem;jenen;jenes;
dies===dies;
derjenige===derjenige;demjenigen;
sÃ¤mtlich===sÃ¤mtlich;
etwas===etwas;
keiner===keiner;
dein===dein;
derselbe===derselbe;dasselbe;
welche===welche;
irgendwas===irgendwas;
etliche===etliche;
alles===alles;
anderleuts===anderleuts;
desselben===desselben;
andere===andere;andre;
diejenige===diejenige;
das===das;
einander===einander;
irgendjemand===irgendjemand;
unser===unser;unsere;unserem;unseren;unserer;unseres;
selbst===selbst;
beide===beide;beider;
ebendieser===ebendieser;
der===der;
du===du;
irgendein===irgendein;
selber===selber;
paar===paar;
dieser===dieser;diese;diesem;diesen;dieses;
deine===deine;
anderes===anderes;andres;
anderer===anderer;andrer;
welcher===welcher;
Ihr===Ihr;Ihre;
was===was;
jeglicher===jeglicher;
ich===ich;
wir===wir;
ihre===ihre;
dir===dir;
anderem===anderem;anderm;andrem;
jemand===jemand;
mehrere===mehrere;
dergleichen===dergleichen;
anderen===anderen;andern;andren;
sowas===sowas;
mein===mein;
die===die;
wer===wer;
jeder===jeder;
manch===manch;mancher;
solch===solch;solche;solchem;solchen;solcher;solches;
all===all;
man===man;
dich===dich;
sie===sie;
mir===mir;
wovon===wovon;
selbig===selbig;
sein===sein;seine;
nichts===nichts;
selbe===selbe;selben;
nix===nix;
irgendetwas===irgendetwas;
ihr===ihr;
frau===frau;
niemand===niemand;
Sie===Sie;
jedermann===jedermann;
es===es;
er===er;
